-------------------------
-------------------------
-------------------------
-------------------------
-------------------------
-------------------------
-------------------------
---------------XSS--o----
-------E------XXX--------
------<>-----XXXX-SS-----
------[]----XXXXX--------
------[]---XXXXXX--SSS---
E-----[]--XXXXXXX--------
XXXXXXXXXXXXXXXX------XXX