-------------------------
-------------------------
-------------------------
-------------------------
---------E---------------
----SSQSSSS--------------
-------------------------
-------------------------
-------------------------
----SSSSSSS--------------
-------------------------
--X----------------------
--X----------------------
XXXXXXXXXXXXXXXXXXX-XXXXX