-------------------------
-------------------------
-------------------------
-------------------------
-------------------------
-------------------------
-------------------------
-------------------------
---------E---------------
--E-----<>---------------
-<>--B--[]---------------
-[]--b--[]---------------
-[]--B--[]---------EE-E-E
-XXXXXXXXXXXX--XXXXXXXXXX