------------------------------
------------------------------
------------------------------
------------------------------
------------------------------
--SS--SSSSSSSSS---------------
------------------------------
------------------------------
------------------------------
-----------------------EE-----
-----------------X-XXXXXX--XX-
------------------------------
------------------------------
XX--XX---------X---------X---X