------------------------------
------------------------------
---------------------------oo-
--------------------?-----XXXX
------------------------------
--SS--SSS---------------------
-------------ooo------E-------
------------------XXXXXX------
------------------------------
--------------XXXX-----ooo----
-------------------------E----
-----------------XXXXXXXXXX---
------------XX----------------
XX--XX---X--------------------