------------------------------
------------------------------
------------------------------
------------------------------
------------------------------
SSSS--SSSS------S-------------
------------------------------
------------------------------
SSSS------EEEEEE-EEEEEEEEEEEEE
------------------------------
------------------------------
------------------------------
------------------------------
----XXXX----------------------