------------------------------
------------------------------
------------------------------
------------------------------
------------------------------
--SS--SSSSS---SSSS--SS--------
------------------------------
------------------------------
------------------------------
--------------------------EEEE
------------------------XXXXXX
------------------------------
------------------------------
XX--XX------XX----XX--XX------