------------------------------
------------------------------
------------------------------
------------------------------
------------------------------
-----------------S------S-----
------------------------------
------------------------------
---------------EE-EEEEEE-EEEEE
---X------X-------------------
---X------X-------------------
---X------X-------------------
---X------X-------------------
---X------X-------------------