------------------------------
------------------------------
------------------------------
------------------------------
------------------------------
----------S-----S------S------
------------------------------
---X--------------------------
---X--E-EE-EEEEE-EEEEEE-EEEEEE
-X-X--------------------------
-X-X--------------------------
-X-X--------------------------
-X-X--------------------------
-X-X--------------------------