------------------------------
------------------------------
------------------------------
------------------------------
------------------------------
------------------------------
-----------------------XXX----
------------------------------
------------------------------
--------EE-EE-EE-EE-----------
--XX--XXXXXXXXXXXXXXXXXX------
------------------------------
------------------------------
X---X-------------------------