------------------------------
------------------------------
------------------------------
------------------------------
------------------------------
------------------------------
------------------------------
------------------------------
------------------------------
--------------------------E---
------------<------------<>---
------------[------------[]---
-E---E------[-E---E------[]-E-
XXXXXXXXXX-XXXXXXXXXXXX-XXXXXX