------------------------------
------------------------------
------------------------------
------------------------------
------------------------------
SSSS------SSSSSSSS---SSSS----S
------------------------------
------------------------------
SSSS---------------------EEEE-
------------------------------
------------------------------
------------------------------
-------E----------------------
----XXXXXXXX-------XXXX-------