------------------------------
------------------------------
------------------------------
------------------------------
------------------------------
------------------------------
------------------------------
------------------------------
------------------------------
--------E-EE-E-E-E-E-EE-EE-EE-
--XX--XXXXXXXXXXXXXXXXXXXXXXXX
------------------------------
------------------------------
X---X-------------------------