------------------------------
------------------------------
------------------------------
------------------------------
------------------------------
SSSS--------SSSS------S-S----S
------------------------------
------------------------------
SSSS------------EEEEEE-E-EEEE-
------------------------------
------------------------------
------------------------------
------E-----------------------
----XXXXX-XXXX----------------