-------------------------
-------------------------
-------------------------
-------------------------
-------------------------
-------------------------
-------------------------
-------------------------
---S---E-------E---------
------<>------<>---------
------[]------[]--B------
------[]------[]--b------
------[]------[]---------
XXXXXXXXXXXXXXXXXXXXXXXXX