-------------------------
-------------------------
-----------?-------------
-------------------------
-------------------------
--------------------XXXX-
-------------SS----XXXXX-
------------------XXXXXX-
-----SSSSSS------XXXXXXX-
----------------XXXXXXXX-
---------------XXXXXXXXX-
--------------XXXXXXXXXX-
E------------XXXXXXXXXXX-
XXXXXXXXXXXX-XXXXXXXXXXXX