------------------------------
------------------------------
------------------------------
---------------------XXXX-----
---------------------XXXX-----
--SS--S--SS--SSSSSS--XXXX-----
---------------------XXXX-----
---------------------XXXX-----
---------------------XXXX-----
---------------------XXXX-----
---------------------XXXX-----
---------------------XXXX-----
---------------------XXXX---EE
XX--XX-XX--XX------XXXXXXXXXXX