------------------------------
------------------------------
------------------------------
------------------------------
----------------XX------------
------------------------------
--------------E---------------
--------XXXXXXXX--------------
------------------------------
----------------------E-EE-E-E
--XX--XXX-----------XXXXXXXXXX
------------------------------
------------------------------
X---X-------------------------