------------------------------
------------------------------
------------------------------
------------------------------
------------------------------
SSSSS----------S--S------S----
------------------------------
------------------------------
SSSSS---------E-EE-EEEEEE-EEEE
------------------------------
------------------------------
------------------------------
-------EEEE-------------------
-----XXXXXXX------------------