------------------------------
------------------------------
------------------------------
-----------------E--E---------
---------------XXXXXXXX-------
------------------------------
-------------E----------------
---------XXXXXX------------XXX
------------------------------
------------------------------
--XX--XXXX---------------XXX-X
------------------------------
------------------------------
X---X-------------------------