------------------------------
------------------------------
------------------------------
------------------------------
-------------------XX---------
------------------------------
---------XXX-----E------------
--------------XXXXX-----------
------------------------------
-------------------------EEEE-
--XX--XXXX-------------XXXXXXX
------------------------------
------------------------------
X---X-------------------------