------------------------------
------------------------------
------------------------------
---------------E--E-----------
-------------XXXXXXXX---------
------------------------------
------------------------------
------------------------------
------------------------------
---------------------------E-E
--XX----XX-------------XXXXXXX
------------------------------
------------------------------
X---X-X---X-------------------