------------------------------
------------------------------
------------------------------
------------------------------
------------------------------
--SS--SSSSSSSSSS--------------
------------------------------
------------------------------
------------------------------
-----------------------E-EE-EE
-------------------XXXXXXXXXXX
------------------------------
------------------------------
XX--XX-----------X------------