------------------------------
------------------------------
------------------------------
------------------------------
------------------------------
SSS-S--SSSSSS---SSSS----S-----
------------------------------
------------------------------
SSS-S---------------EEEE-EEEEE
------------------------------
------------------------------
------------------------------
------------------------------
---X-XXXX-X---XXXX------------