------------------------------
------------------------------
------------------------------
------------------------------
------------------------------
------------------------------
------------------------------
------------------------------
------------------------------
--------EE-EE--------EE-EE-EEE
--XX--XXXXXXX--XX--XXXXXXXXXXX
------------------------------
------------------------------
X---X--------X---X------------