------------------------------
------------------------------
------------------------------
------------------------------
------------------------------
SSSSS------SSSS-S------S------
------------------------------
------------------------------
SSSSS----------E-EEEEEE-EEEEEE
------------------------------
------------------------------
------------------------------
-------EE---------------------
-----XXXXXXXX-----------------