------------------------------
------------------------------
------------------------------
------------------------------
------------------------------
-----------------S----S-------
------------------------------
------------X-----------------
------------X---E-EEEE-EEEEEEE
-----XX-----X-----------------
----XXX-----X-----------------
---XXXX-----X-----------------
--XXXXX-----X-----------------
XXXXXXX-----X-----------------