------------------------------
------------------------------
------------------------------
------------------------------
------------------------------
------------------------------
------------------------------
------------------------------
------------------------------
------------EE-----------EE-E-
--XX--XXXXXXXXXXXXXXXXXXXXXXXX
------------------------------
------------------------------
X---X-------------------------