------------------------------
------------------------------
------------------------------
------------------------------
------------------------------
SSSS-----SSSS-----S-S----S----
------------------------------
------------------------------
SSSS---------EEEEE-E-EEEE-EEEE
------------------------------
------------------------------
------------------------------
------E-----------------------
----XXXXXXX-------------------