------------------------------
------------------------------
------------------------------
------------------------------
------------------------------
SSS--------SSSS------S-S----S-
------------------------------
------------------------------
SSS------------EEEEEE-E-EEEE-E
------------------------------
------------------------------
------------------------------
-----EEE----------------------
---XXXXXXXXXX-----------------