------------------------------
------------------------------
------------------------------
------------------------------
----------------------------XX
------------------------------
--------------------------E---
-------------------X-X-XXXXX--
------------------------------
---------EE-EE-EE-------------
--XX--XXXXXXXXXXXXXXXXXX------
------------------------------
------------------------------
X---X-------------------------