-------------------------
-------------------------
-------------------------
-------------------------
-------------------------
-------------------------
-------------------------
-------------------------
-------------------------
----------<>-------------
----------[]-------------
--<>------[]-------------
--[]--E-E-[]--X-------E--
XXXXXXXXXXXXXXXXXXXXXXXXX