----------------------------
----------------------------
----------------------------
----------------------------
----------------------------
--------------SSS-----------
----------------------------
----------------------------
----SS----------------------
--------E-------------------
-------<>---------------E---
-------[]-------------------
EE-----[]--------E----------
XXXXXXXXXXX-XXXXXXX-XX-X-XX-