------------------------------
------------------------------
------------------------------
------------------------------
------------------------------
SSSSS------------S--S-------S-
------------------------------
------------------------------
SSSSS-----------E-EE-EEEEEEE-E
------------------------------
------------------------------
------------------------------
-------EEEEEE-----------------
-----XXXXXXXXX----------------