------------------------------
------------------------------
------------------------------
------------------------------
------------------------------
--SS--S--SS--SSSSSSSSSS-------
------------------------------
------------------------------
------------------------------
---------------------------EEE
-------------------------XXXXX
------------------------------
------------------------------
XX--XX-XX--XX----------XX-----