------------------------------
------------------------------
------------------------------
------------------------------
------------------------------
--------S------S------S-------
------------------------------
------------------------------
------EE-EEEEEE-EEEEEE-EEEEEEE
---X--------------------------
---X--------------------------
---X--------------------------
---X--------------------------
---X--------------------------