-------------------------
-------------------------
-------------------------
-------------------------
-------------------------
---------SSSSS-----------
-------------------------
-------------------------
----------E------------E-
--------SSSSSS--------<>-
----------------------[]-
----------------------[]-
E---------------------[]-
XXXXXXXXXXXXXXXXXXXXXXXXX