-------------------------
-------------------------
-------------------------
-------------------------
-------------------------
-------------------------
-------------------------
-----E-------------------
----<>-------------------
----[]-------------------
----[]-----------B-------
----[]-----------b-------
----[]----E-E----B-------
-X--XXXXXXXXXXXXXXXXXXXXX