------------------------------
------------------------------
------------------------------
------------------------------
------------------------------
SSSSS--------SSSSSSSSSSS------
------------------------------
------------------------------
SSSSS-------------------------
------------------------------
------------------------------
------------------------------
-------EEEE---------------EEEE
-----XXXXXXXXXX----------XXXXX