-------------------------
-------------------------
-------------------------
-------------------------
-------------------------
--------------------XX---
--------------------XX---
------------------XXXX---
------------------XXXX---
----------------XXXXXX---
---------------XXXXXXX---
--------------XXXXXXXX---
E------------XXXXXXXXX---
XXXXXXXXXXXXXXXXXXXXXXXXX