-------------------------
-------------------------
-------------------------
-------------------------
-------------------------
-------------------------
-------------------------
-------------------------
-------------------------
--Q-----------Q--Q-------
-------------------------
-------------------------
--E------X----E--E----EE-
XXXXX--XXXXXXXXXXXXXXXXXX