------------------------------
------------------------------
------------------------------
------------------------------
------------------------------
SSSSS---------SSSSS------S-S--
------------------------------
------------------------------
SSSSS--------------EEEEEE-E-EE
------------------------------
------------------------------
------------------------------
-------EEEEE------------------
-----XXXXXXXXXXX--------------