------------------------------
------------------------------
------------------------------
------------------------------
------------------------------
SSS--------S------------------
------------------------------
------------------------------
SSS----EEEE-EEEEEEEEEEEEEEEEEE
------------------------------
------------------------------
------------------------------
------------------------------
---XX-------------------------