------------------------------
------------------------------
------------------------------
------------------------------
------------------------------
SS-----S----------------------
------------------------------
------------------------------
SS----E-EEEEEEEEEEEEEEEEEEEEEE
------------------------------
------------------------------
------------------------------
------------------------------
--XX--------------------------