-------------------------
-------------------------
-------------------------
-------------------------
-------------------------
SSS----------------------
-------------------------
-------------------------
SSS----------------------
-------------------------
-------------------------
------------------B------
---------------E--b------
---XXXXXXXXXXXXXXXXXXXXXX