------------------------------
------------------------------
------------------------------
------------------------------
------------------------------
----S--S----------------------
------------------------------
------------------------------
---E-EE-EEEEEEEEEEEEEEEEEEEEEE
------------------------------
------------------------------
------------------------------
------------------------------
X-----------------------------