------------------------------
------------------------------
------------------------------
------------------------------
------------------------------
SS------SSSSSSSSSSSSSSSS------
------------------------------
------------------------------
SS--S-SS----------------------
------------------------------
------------------------------
------------------------------
--------------------------EEEE
--XXXXXXX----------------XXXXX