------------------------------
------------------------------
------------------------------
------------------------------
------------------------------
--S--------SSSSSSSSSSSSS------
------------------------------
------------------------------
-E-EE-------------------------
-----XX-----------------------
-----XX-----------------------
-----XX-----------------------
-----X--------------------EEEE
-----X---XXXX------------XXXXX