------------------------------
------------------------------
------------------------------
------------------------------
------------------------------
--S---------------------------
------------------------------
------------------------------
-E-EEEEEEEEEEEEEEEEEEEEEEEEEEE
------------------------------
------------------------------
------------------------------
------------------------------
------------------------------