------------------------------
------------------------------
------------------------------
------------------------------
------------------------------
------S-----------------------
------------------------------
------------------------------
-o--EE-EEEEEEEEEEEEEEEEEEEEEEE
------------------------------
------------------------------
------------------------------
------------------------------
------------------------------