-------------------------
-------------------------
-------------------------
-------------------------
-------------------------
----SSQ-------------SQQS-
-------------------------
-------------------------
-------------------------
------S--<>----------SS--
---------[]--------------
---------[]--------------
-------E-[]---E-EE-E-E---
XXXXXXXXXXXXXXXXXXXXXXXXX