------------------------------
------------------------------
------------------------------
------------------------------
------------------------------
------SSSSSSSSS---------XXX---
-----------------------XXXX---
----------------------XXXXX---
---------------------XXXXXX---
---------------------XXXXXX---
-------------------XXXXXXXX---
------------------XXXXXXXXX---
---------------------XXXXXX---
XXXXXXXX--------XXXXXXXXXXXXXX