------------------------------
------------------------------
---------------oo-------------
-------------------E--E--E----
------------------XXXXXXXXXX--
-----------oo-----------------
------------------------------
------------------------------
------------XXXXXX------------
--------E---------------------
------E<>---------------------
-----<>[]---------------------
-----[][]---------------------
XXXXXXXXX---------------------