------------------------------
------------------------------
------------------------------
------------------------------
------------------------------
-----------S------------------
------------------------------
------X-----------------------
-----XX-----------------------
-----XX--QQQQ-----------------
---XXXX-----------------------
--XXXXX-----------------------
-----XX--------------XX-----XX
XXXXXXXXXXXXXXX--XX------X----