-------------------------
-------------------------
-------------------------
-------------------------
-------------------------
--XX------SSSS-----------
--XX---------------------
--XX---------------------
--XX---------------SSSSSS
--XX--XX--SSSS-----------
--XX--XX-----------------
------XXX----------------
------XXX----------------
XXXXXXXXXXXXXXXXXXXXXXXXX