------------------------------
------------------------------
------------------------------
------------------------------
------------------------------
------------------------------
------------------------------
------------------------------
------------------------------
------------------------------
--------------------------X---
-----------------------X-XX---
---X---XX------E------XXXXXE--
X---X------XXXXXXXXXXXXXXXXXXX