-----------------------------
-----------------------------
-----------------------------
-----------------------------
---oo------------------------
--------oo-------------------
--------------oo--------oooo-
-----------------------------
-----------------------------
----XXXX--XX-----------------
----------------------X------
----------------------X------
----------------------X------
X-------------XXXXXXXXXXXXXXX