-------------------------
-------------------------
-------------------------
-------------------------
-------------------------
SS-----------------------
-----E-------------------
----<>-------------------
SS--[]-------------------
----XX-----------E-------
----------------<>-------
-------B--------[]-------
-------b--------[]-------
--XXXXXXXXXXXXXXXX--XXXXX