------------------------------
------------------------------
------------------------------
------------------------------
------------------------------
------------------------------
-----------------------oo-----
------------------------------
------------------------------
------------------------------
---------------------X--------
---------------------X--------
---XX------XX--------X--------
X------XX------XXXXXXXXXXXX---