-------------------------
-------------------------
-------------------------
-------------------------
-------------------------
--?----------------------
-------------------------
-------------------------
-------------------------
--Q--------------<>--SS--
-----------------[]------
-----------------[]------
-------EE-E-E-EE-[]------
XXXXXXXXXXXXXXXXXXXXXXXXX