------------------------------
------------------------------
------------------------------
------------------------------
------------------------------
-----------------------S-SSSSS
------------------------------
------------------------------
------------------------------
------------------------------
------------------------------
------------------------------
---X---XX---X---XXX-----------
X---X----X---X-------XXXXXX-X-