-------------------------
-------------------------
-------------------------
-------------------------
-------------------------
---------------XX--------
---------------XX--------
-------------XXXX--------
---o---------XXXX--------
-----------XXXXXX----SS--
---------EXXXXXXX--------
---------XXXXXXXX--------
--------XXXXXXXXX--------
-XXXXXXXXXXXXXXXXXXXXXXXX