-------------------------
-------------------------
-------------------------
-------------------------
-------------------------
-----------SSSQ----------
-------------------------
----------E--------------
-------------------------
--------S?S---S----------
-------------------------
-------------------------
---X-----------E--E-EE-EE
XXXXXXXXXXXXXXXXXXXXXXXXX