------------------------------
------------------------------
------------------------------
------------------------------
------------------------------
------------------------------
------------------------------
------------------------------
------------------------------
------------------------------
---X------X-------X------X----
------------------------------
E---E-EE---E-E-E---E-EE---E-E-
XXX-XXXXXX-XXXXXXX-XXXXXX-XXXX