-----------------------------
-----------------------------
-----------------------------
-----------------------------
-----------------------------
-----------------------------
-----------------------------
-----------X-----------------
---E------XX---E-------------
--<>------XX--<>-------------
--[]----XXXX--[]-------------
--[]---XXXXX--[]-------------
--[]------XX--[]----E-EE-EE--
XXXXXXXXXXXXXXXXXXXXXXXXXXXXX