-------------------------
-------------------------
-------------------------
-------------------------
-------------------------
---------------SSS-------
-------ooo---------------
-------------------------
-----E-------------------
----<>--------XXXXX------
----[]--------X----------
----[]--------X----------
--E-[]--------X----------
-XXXXXXXXXXXXXXXX------XX