------------------------------
------------------------------
------------------------------
------------------------------
------------------------------
------------------------------
------------------------------
------------------------------
-------------------E-E--------
------------------<>->--------
------------------[]-]--------
------------------[]-]--<>--<>
---X---XXX--X-XX--[]-]--[]--[]
X---X-------------XXXXXXXXXXXX