------------------------------
------------------------------
------------------------------
------------------------------
------------------------------
----------------------------E-
---------------------------XXX
------------------------------
----------------------E-------
--------------------E<>-------
----------------E--<>[]-------
---------------<>--[][]-------
---------------[]--[][]-------
XXXXX--XXXX--XXXXXXXXXXXX-----