-------------------------
-------------------------
-------------------------
-------------------------
-------------------------
-------------------------
-------------------------
-------------------------
------Q------------------
-----E-------------------
-----E-------------------
-----------B-------------
-----------b-------------
XXXXXXXXXXXXXXXXX--XXXXXX