-------------------------
-------------------------
-------------------------
-------------------------
-------------------------
-------------------------
---------XXX-------------
-------------------------
-----------------E-------
---E------------<>-------
--<>------------[]-------
--[]------------[]-------
--[]------------[]-------
XXXXXXX---XXXXXXXXXXXXXXX