-------------------------
-------------------------
-------------------------
-------------------------
-------------------------
---------------XXX-------
--------------XXXX-------
-------------XXXXX-------
------------XXXXXX-------
-----------XXXXXXX-------
----------XXXXXXXX-------
---------XXXXXXXXX--B----
E-EE----XXXXXXXXXX--b----
XXXXXXXXXXXXXXXXXXXXXXXXX