----------------------------
----------------------------
----------------------------
----------------------------
----------------------------
------------SSSSS-----------
----------------------------
---------------------------X
--------------------------XX
-------------------------XXX
------------------------XXXX
--------------------<>-XXXXX
-EE------X----------[]XXXXXX
XXXX-XXXXXXXXX----XXXXXXXXXX