-------------------------
-------------------------
-------------------------
-------------------------
-------------------------
------------------------S
-------------------------
-------------------------
--------------------S----
-------------------------
-------------------------
-------------------------
-EE-E-E-------EE-------E-
XXXXXXXXXXXXXXXXXXXXXXXXX