-------------------------
-------------------------
-------------------------
-------------------------
-------------------------
-------------------------
-------------------------
---------------------XX--
---------------------XX--
---------------------XX--
--------------------XXX--
----B---------------XXX--
----b---------------XXX--
XXXXXXXXXXXXXXXXXXXXXXX--