------------------------------
------------------------------
------------------------------
------------------------------
------------------------------
-----------------------SS-----
------------------------------
------------------------------
------------------------------
------------------------------
-----------------------------X
----------------------------XX
-EE---EE---EE---EE---------XXX
XXXXXXXXXXXXXXXXXXXXXXX--XXXXX