-------------------------
-------------------------
-------------------------
-------------------------
-------------------------
-------------------------
-------------------------
-------------------------
-------------------------
-------------------------
-------------------------
-------------<>--<>------
-------X-----[]--[]------
XXXXXXXXXXXXXXXXXXXXXXXXX