-------------------------
-------------------------
-------------------------
-------------------------
-------------------------
---------------XXX---SSSS
--------------XXXX-------
-------------XXXXX-------
------------XXXXXX----E--
-----------XXXXXXX--SSSSS
----------XXXXXXXX-------
---------XXXXXXXXX-------
E-EE----XXXXXXXXXX-------
XXXXXXXXXXXXXXXXXXXXXXXXX