-------------------------
-------------------------
-------------------------
-------------------------
-------------------------
-------------------------
-------------------------
-------------------------
------oo-----------------
-------------------------
-------------------------
-------------------------
-EE----------EE-E----X---
XXXX-----XXXXXXXXXXXXXXXX