-------------------------
-------------------------
-------------------------
-------------------------
-------------------------
-------------S-----------
-------------------------
-------------------------
-------------------------
-E-------XX--S-----------
<>------XXX-------------X
[]-----XXXXX----X------XX
[]----XXXXXX----X-----XXX
XXXXXXXXXXXXXXXXXXXXXXXXX