---------------------------
---------------------------
---------------------------
---------------------------
---------------------------
---SSS---------------------
---------XXX---------------
---------------------------
---------------------------
--------------------E-----E
-------------------<>------
-------------------[]------
-------------------[]------
XXXXX-X---XXXX-XX--XXXXXXXX