-------------------------
-------------------------
-------------------------
-------------------------
-------------------------
-----------------------S-
-------------------------
-------------------------
---E---------------------
--<>---------------------
--[]--------------------E
--[]---------E---------<>
--[]----------------E--[]
XXXXXXXX---X-X-XXX-XXXXXX