------------------------------
------------------------------
------------------------------
------------------------------
------------------------------
---------------------SSSSSSSS-
------------------------------
------------------------------
------------------X-----------
-----------------XX----------S
----------------XXX-----------
---------------XXXX-----------
--------------XXXXX-----------
XX--XXXXX--XXXXXXXXXXXXXX----X