------------------------------
------------------------------
------------------------------
------------------------------
------------------------------
-----SS-------SS-----SSSSQ----
------------------------------
----E--------E----------------
------------------------------
--S?S------S?S-----------S----
------------------------------
------------------------------
--------------------------E-E-
XXXXXXXXXXXXXXXXXXXXXXXXXXXXXX