-------------------------
-------------------------
-------------------------
-------------------------
-------------------------
------------SS-----------
-------------------------
-------------------------
---------E--SS-------E---
--------<>-------E--<>---
--------[]------<>--[]---
--------[]------[]--[]---
-E------[]------[]--[]--X
XXXXXXXXXXX---XXXXXXXXXXX