-------------------------
-------------------------
-------------------------
-------------------------
-------------------------
-------------------------
-------------------------
-------------------------
----------o--------------
-------S-----------------
-------------------------
-------------------------
-------------------------
XXXXXXXXXXXXXXXXXXXXXXXXX