------------------------------
------------------------------
------------------------------
------------------------------
------------------------------
------?SS------?SS------------
------------------------------
------------------------------
----E--------E--------------E-
S--<>---ES--<>---ES-----S--<>-
---[]--<>---[]--<>---------[]-
---[]--[]---[]--[]---------[]-
---[]--[]---[]--[]---E-E---[]-
XXXXXXXXXXXXXXXXXXXXXXXXXXXXXX