------------------------------
------------------------------
------------------------------
------------------------------
------------------------------
---SS---SS---SS---SSSSS---SSSS
------------------------------
------------------------------
------------------------------
------------------------------
------------------------------
------------------------------
------------------------------
XXXXXXXXXXXXXXXXXXXXX---XXXXXX