-------------------------
-------------------------
-------------------------
-------------------------
-------------------------
---------------------SSSS
------ooo----------------
-------------------------
----E--------------------
---<>-------------E-X----
---[]------------<>-X----
---[]------------[]-X----
---[]------------[]-X----
XXXXXXXXXXXXXX--XXXXXXX--