------------------------------
------------------------------
------------------------------
------------------------------
------E---------E-------------
---SSSS------SSSS---------SSSS
------------------------------
------------------------------
------------------------------
------------------------------
--------------------<>--------
--------------------[]--------
--------------------[]-E------
XXXXXXXXXXXXXXXXXXXXXXXXXXXXXX