-------------------------
-------------------------
-------------------------
-------------------------
-------------------------
-------------------------
--E----------------------
-<>----------------------
-[]----------------------
-XXX--E----XX------------
------E------------------
-------------------------
--------------------E----
XXXXXXXXXXX----XXXXXXXXXX