-------------------------
-------------------------
-------------------------
-------------------------
-------------------------
------------XX-----------
-----------XXX-----------
----------XXXX-----------
---------XXXXX-----------
--------XXXXXX-----------
-------XXXXXXX-----------
------XXXXXXXX-----------
-E---XXXXXXXXX-----------
XXXXXXXXXXXXXXXXXXX--XXXX