-------------------------
-------------------------
-------------------------
-------------------------
-------------------------
-------------------------
-------------------------
-------------------------
-------------------X-----
---------E--------EX----<
--------<>----E--XXX----[
--------[]------XXXX----[
---X----[]-----XXXXX----[
XXXXXXXXXXXXXXXXXXXXXXXXX