-------------------------
-------------------------
-------------------------
-------------------------
-------------------------
----------------------SS-
-------------------------
-------------------------
--------o----------------
------E--------------XXXX
-E---<>-----------XXXXX--
-----[]--------XXXXXX----
-----[]-------XXXXX------
X-XXXXXXXXXXXXXXX------XX