-------------------------
-------------------------
-------------------------
-------------------------
-------------------------
--------------XX---------
--------------XX---------
--------------XX---------
-----------XX-XX---------
----------XXX-XX-------QQ
---------XXXX-XX---------
--------XXXXX-XX---------
------XXXXXXX-XX---------
XXXXXXXXXXXX--XXXXXXXXXXX