--------------------------
--------------------------
--------------------------
--------------------------
--------------------------
--S-----------------------
--------------------------
--------------------------
-E-EE------------------oo-
-----XX-X-----------------
-----XX-X-----------------
-----XX-X-----------------
-----X--X-----------------
-----X--X--XXX-XXXXXX-----