-------------------------
-------------------------
-------------------------
-------------------------
-------------E--E--------
--S-------SSSSSSSSSSQ----
-------------------------
-------------------------
-E-EE--------------------
-----XX-XX----------S----
-----XX-XX---------------
-----XX-XXX--------------
-----X--XXX----------E-E-
-----X--XXXXXXXXXXXXXXXXX