------------------------------
------------------------------
------------------------------
------------------------------
------------------------------
--SS-----SS-------------------
------------------------------
------------------------------
---------------o--------------
------------------------------
------------------------------
------------------------------
-------------------E----------
XX---XXXX---XX---XXXXXXXXXX-X-