-----------------------
-----------------------
-----------------------
-----------------------
-----------------------
------SS---------------
-----------------------
-----------------o-----
------SS---------------
-------------ESSS------
-----------------------
-----------------------
EE-E-----------------EE
XXXXX---XXXXXXXXXXXXXXX