------------------------------
------------------------------
------------------------------
------------------------------
------------------------------
------------------------------
------------------------------
------------------------------
------------------------------
------------------------------
------------------------------
------------------------------
E---E-E---E--E---E-E---E------
XXXXXXXXXXXX-XXXXXXXXXXXX-XXXX