-------------------------
-------------------------
-------------------------
-------------------------
-------------------------
---------------------XX--
--------------------XXX--
-------------------XXXX--
------------------XXXXX--
-----------------XXXXXX--
-X--E--------E--XXXXXXX--
-X-------------XXXXXXXX--
-X------------XXXXXXXXX--
-XXXXXXXXXXXXXXXXXXXXXXXX