------------------------------
------------------------------
------------------------------
------------------------------
------------------------------
---------------Q-Q------------
------------------------------
------------------------------
------------------------------
---------------Q-Q--------E---
---<------<------------<-<>---
---[------[------------[-[]---
E--[E--E--[E-----------[-[]---
XXXXXXXXXXXXXXXXXXXX--XXXXXXX-