-------------------------
-------------------------
-------------------------
-------------------------
-------------------------
-------------------------
-------------------------
-------------------------
-------------------------
-------------X-----------
-------------XX----------
-------------XXX---------
-------X-----XXXX--------
XXXXXXXXXXXXXXXXXXXXXXXXX