------------------------------
------------------------------
------------------------------
------------------------------
------------------------------
------?S------?SS--------?SSS-
------------------------------
------------------------------
----E-------E--------E-E------
S--<>---S--<>---ES--<><>---E--
---[]--<---[]--<>---[][]--<>--
---[]--[---[]--[]---[][]--[]--
---[]--[---[]--[]---[][]--[]--
XXXXXXXXXXXXXXXXXXXXXXXXXXXXXX