-------------------------
-------------------------
-------------------------
-------------------------
-------------------------
---------------------E---
--------------------<>---
-----------E--------[]---
o---------<>--------XXX--
----------[]-------------
----------[]------------E
----------[]-----------<>
---XXXXX--[]----EE-----[]
----------XXXXXXXXXXXXXXX