-----------------------------
-----------------------------
-----------------------------
----------------------o------
-----------------------------
----------S-------SSSSS------
-----------------------------
-----------------------------
---------E-EE----------------
-----XX------XX-XX---S-------
----XXX------XX-XX----------<
---XXXX------XX-XXX---------[
--XXXXX------X--XXX---E-----[
XXXXXXX------X--XXXXXXXXX---X