---------------------------
---------------------------
---------------------------
---------------------------
---------------------------
--------SSSSSS-------------
---------------------oo----
---------------------------
-------------------E-------
----------S------E<>------E
------------E---<>[]-----<>
----------------[][]-----[]
EE-EE-----------[][]-----[]
XXXXXXXXXXXXXXXXXXXXXXXXXXX