-------------------------
-------------------------
-------------------------
--------------------o----
-------------------------
------------------SSS----
-------------------------
---XX--------------------
---XX-----oo-------------
-XXXX--------------S---XX
-XXXX-----------E--------
-XXXX----------<>--------
-XXXX----------[]---E----
-XXXX--X-----XXXXXXXXXX--