-------------------------
-------------------------
-------------------------
-------------------------
-------------------------
-------------------------
-------------------------
-------------------------
---S---------------------
------E------E------E---S
-----<>-----<>----E<>----
-----[]-----[]---<>[]----
E----[]-----[]---[][]----
XXXXXXXXXXX-XXXXXXXXXXXXX