-------------------------
-------------------------
-------------------------
-------------------------
-------------------------
-------------------------
--------------oo---------
-------------------------
------------E------------
-E---------<>------------
<>---------[]------------
[]---------[]------------
[]-----XX--[]--------X---
XXXXXXXXXXXXXXXXXXXXXXXXX