------------------------------
------------------------------
------------------------------
------------------------------
------------------------------
------------------------------
------------------------------
------------------------------
----------E------E-E----------
----<----<>-----<>->----------
----[----[]-----[]-]----------
----[----[]-----[]-]----------
----[----[]-----[]-]----------
XXXXXXXXXXXXXXXXXXXXXXXXXXXXXX