------------------------------
------------------------------
------------------------------
------------------------------
------------------------------
--------SSS----SSSS---SS------
------------------------------
------------------------------
-----------------------------X
-----------------------------X
---------------------------XXX
--------------------------XXXX
-EE--------------------------X
XXXXXXXXXX-X-XXXX---XXXXXXXXXX