--------------------------
--------------------------
--------------------------
--------------------------
--------------------------
--S-----------------------
--------------------------
--------------------------
-E-EE-----------------E---
-----XXX-X-----------<>---
-----XXX-X-------E---[]---
-----XXX-X------<>---[]---
-----X---X------[]---[]---
-----X---X--XXXXXXXXXXXXXX