------------------------------
------------------------------
------------------------S-SSSS
------------------------------
------------------------------
----------------SSSS----------
------------------------------
------------------------------
------S------SSS--------------
------------------------------
----E------E------------------
---<>-----<>------------------
---[]-----[]------------------
XXXXXXXXXXXXXXXXX---XXXXXXXXXX