------------------------------
------------------------------
-------------------------oo---
-----------------------------E
--------------Eooo----------XX
------SSS-----XXXXX-----------
------------------------------
------------------------------
-----------------------XXXXX--
-----XXXXX--XXXXXXXX----------
-----X------------------------
E----X---------------o--------
-----X--------------XXX-------
X-XXXXXX----------------------