----------------------------
----------------------------
----------------------------
----------------------------
----------------------------
---SSSS-----E-----E------E--
-----------XXXX--XXXXX--XXXX
----------------------------
----------------------------
----------------------------
----------------------------
----------------------------
----------------------------
XXXXX---X-------------------