------------------------------
------------------------------
------------------------------
------------------------------
------------------------------
-------------------------S----
------------------------------
--------------------XX--------
--------------------XX--E-EE--
------------------XXXX------XX
--------X--------XXXXX------XX
---X---XX---X---XXXXXX------XX
--XX--XXX--XX--XXXXXXX------X-
XXXXXXXXXXXXXXXXXXXXXX------X-