------------------------------
------------------------------
------------------------------
------------------------------
------------------------------
------------------------------
------------------------------
------------------------------
------------------------------
----------------------------XS
------------------------E---X-
---------------------<-<>---X-
-EE---EE---EE---EE---[-[]--EX-
XXXXXXXXXXXXXXXXXXXXXXXXXXXXXX