-------------------------
-------------------------
-------------------------
-------------------------
-------------------------
----S--------------------
---------------------E---
--------------------<>---
---E-EE-------------[]---
-------XX-X---------XXX--
-------XX-X--------------
-------XX-X--------------
-------X--X---XXX--------
-------X--X--------XXXXXX