-------------------------
-------------------------
-------------------------
-------------------------
-------------------------
-------------------------
-------------------------
-------------------------
-------------------------
XSS---------------------<
X-----------------------[
X-----------------------[
X-------------E---------[
XXXXXXXXXXXXXXXXXXXXXXXXX