------------------------------
------------------------------
------------------------------
------------------------------
-------------E----------------
-----------SSSSS-----E--------
--------------------XXXX------
------------------------------
----S-------------------------
----------X----------------E--
----------X---------------<>--
----------X---------------[]--
E------X--X-----E---------[]--
XXXXXXXXXXXXXXXXXX--------XXXX