------------------------------
------------------------------
------------------------------
------------------------------
----------------------oo------
----------------------XX------
------------------------------
------------------------------
------------------------------
--------E--------EE-----------
--XX--XXX--XX--XXXXXX?--------
------------------------------
------------------------------
X---X----X---X-------XXX-X-X-X