-------------------------
-------------------------
-------------------------
-------------------------
----ooo------------------
----XXX------------------
-------------------------
-------------------------
------------------o------
--------------XX---------
XXX?---------XXX---------
------------XXXX---------
-----------XXXXX---------
---XXXX-XXXXXXXX----XXXXX