------------------------------
------------------------------
------------------------------
------------------------------
------------------------------
--SQ--SQ--SQ--SQQS---SQSQ--SQQ
------------------------------
------------------------------
------------------------------
---S---S---S---SS-----S-S---SS
------------------------------
------------------------------
-E-E-E-E-E-E-E-E----E-E-E-E-E-
XXXXXXXXXXXXXXXXXXXXXXXXXXXXXX