-------------------------
-------------------------
-------------------------
-------------------------
-------------------------
-------------------XX----
------------------XXX----
-----------------EXXX----
----------------XXXXX----
--E------------XXXXXX----
-<>-----------XXXXXXX----
-[]----------XXXXXXXX----
-[]---------XXXXXXXXX----
-XXXXXXX-XXXXXXXXXXXXXXXX