-----------------------------
-----------------------------
-----------------------------
-----------------------------
-----------------------------
--SQQS----XX----------SSSSSSS
----------XX-----------------
----------XX-----------------
----------XX-----------------
---SS-----XX-----------------
----------XX-----------------
-----------------------------
-E-E------------XX-----------
XXXXXXXXXXXXXX------XXXX-----