------------------------------
------------------------------
------------------------------
------------------------------
------------------------------
------------------------------
------------------------------
------------------------------
------------------------------
----------------------XX--X---
---------------------XXX--XX--
--------------------XXXX--XXX-
---X--------X------XXXXX--XXXX
XXXXXX--XXXXXXX--XXXXXXX--XXXX