------------------------
------------------------
------------------------
------------------------
------------------------
------------------------
------------------------
------------------------
--o--------XSS-SQ-------
----------XXX-----------
---------XXXX-----------
--------XXXXX---------X-
-------XXXXXX--SSSSS--X-
----XXXXXXXX-------XX-X-