-------------------------
-------------------------
-------------------------
-------------------------
-------------------------
-------------------------
-------------------------
-------------------------
o------------------------
---------XX------------S-
---E---------------E-----
------------------<>-----
------------------[]-----
--X-XX-------XXXXXXXXXXXX