------------------------------
------------------------------
------------------------------
------------------------------
------------------------------
------------------------------
------------------------------
------------------------------
------------------------------
--Q-----Q---Q-----Q-----------
---------------------------<><
---------------------------[][
--E-----E---E-----E--------[][
XXXXX-XXXXXXXXX-XXXXX--X-XXXXX