-------------------------
-------------------------
-------------------------
-------------------------
-------------------------
----------SQQS---SSS-----
-------------------------
-------------------------
-------------------------
-E---------SS--XX--------
<>-------------XX--------
[]-------------XXX-------
[]-------E-E---XXX--E-E--
XXXXXXXXXXXXXXXXXXXXXXXXX