------------------------------
------------------------------
------------------------------
------------------------------
------------------------------
---SSS---SSSS-----------------
------------------------------
------------------------------
------------------------------
S-----S-------------S-SS-S---S
------------------------------
------------------------------
----------------EE------------
XXXXX-XXXXX---XXXXX-X-XXXXXXXX