------------------------------
------------------------------
------------------------------
------------------------------
------------------------------
-SSSS-------------XXX---------
---------------X-XXXX---------
--------------XXXXXXX---------
--E----------XXXXXXXX----o----
SSSSS--------XXXXXXXX---------
-----------XXXXXXXXXX---------
----------XXXXXXXXXXX---------
-------------XXXXXXXX---------
XXXXXXX-XXXXXXXXXXXXXXXX-----X