----------------------------
----------------------------
----------------------------
----------------------------
-----------------Eoo--------
-------------E---XXXX-------
----------------------------
---------XX-----------------
-------------------------XX-
---------------XXXXXXX------
----------------------------
-----------------------o----
--XX--------ooo-------XXX---
XXXXXXX-----XXX-------------