-------------------------
-------------------------
-------------------------
-------------------------
--------oo-----E---------
---------------E--E------
-----------------XXXXXX--
-------------------------
-------------------------
---------XXXXX-----------
-------------------------
-------------------------
-------------------------
-XXX---------------------