------------------------------
------------------------------
------------------------------
------------------------------
------------------------------
-----------------------------X
-----------------------------X
---------------------------XXX
---------------------------XXX
---------------------------XXX
--------------------------XXXX
------------------<>------XXXX
------------------[]------XXXX
XXXXXXXXXXXXXXXXXXXXXXXXXXXXXX