------------------------------
------------------------------
------------------------------
------------------------------
------------------------------
---------------------------SSS
------------------------------
------------------------------
------------------------------
------------------------------
------------------E-----------
-----------------<>-----------
EE--EEEEE--EEE---[]-EEEEE-----
XXXXXXXXXXXXXXXXXXXXXXXXXXX---