-------------------------
-------------------------
-------------------------
-------------------------
-------------------------
-------------------------
------------------XSSS---
-----------------XXX-----
o-----E---------XXXS-----
-----<>--------XXXXX-----
-----[]----E--XXXXXX-SSS-
-----[]------XXXXXXX-----
-----[]-----XXXXXXXX-----
--XXXXXXXXXXXXXXXXXXXX---