------------------------------
------------------------------
------------------------------
------------------------------
------------------------------
------------------------------
------------------------------
------------------------------
------------------------------
------------------------------
-----------------------------X
----------------------------XX
E-EE----E-EE-----E-E-EE----XXX
XXXXXXXXXXXXXXXXXXXXXXXXXXXXXX