------------------------------
------------------------------
------------------------------
------------------------------
------------------------------
----------------------SSSSSSSS
------------------------------
------------------------------
------------------------------
------------------------------
-------------------E----------
------------------<>----------
-E-E--E--E-E--E---[]----------
XXXXXXXXXXXXXXXXXXXXXXXX------