-------------------------
-------------------------
-------------------------
-------------------------
--------oo---E-----------
-------------E--E------oo
---------------XXXXXX----
----X--------------------
----X-------------------X
--X-X----XXX-------------
--X-X--------------------
--X-X--------------------
--X-X--------------------
--X-X--------------------