------------------------------
------------------------------
------------------------------
------------------------------
------------------------------
---SS-----SS--------SS---SSQ--
------------------------------
------------------------------
------------------------------
---------------------------S--
------------------------------
------------------------------
---------------E------------E-
XXXXXXXXXXXXXXXXXXXXXXXXXXXXXX