------------------------------
------------------------------
------------------------------
------------------------------
------------------------------
------------------------------
-----------------XSSS---------
--------oo------XXX-----------
---------------XXXS-----------
----XXX--------XXXX-----------
----XXX------XXXXXX-SSS--E----
----XXX-----XXXXXXX-----------
----XXX--------XXXX-----------
-XXXXX---XXXXXXXXXXXX---X-XXXX