------------------------------
------------------------------
------------------------------
------------------------------
------------------------------
-----S---------S-----------S--
------------------------------
------------------------------
----E-EE------E-EE--------E-EE
--------XX--------XX-X--------
--------XX--------XX-X--------
--------XX--------XX-X--------
--------X---------X--X--------
XX------X-XX------X--X--------