-------------------------
-------------------------
-------------------------
-------------------------
-------------------------
------S------------------
-------------------------
-------------------------
-oo----------------------
-------------------------
-------E-----------------
------<>-----E-----------
------[]-----------EE-EE-
----XXXXXXXX-X-XXXXXXXXXX