---------------------------
---------------------------
---------------------------
---------------------------
---------------------------
--S------------------------
---------------------------
-------------------------X-
-E-EE--------------------X-
-----XX-X----E--------XX-X-
-----XX-X---<>--------XX-X-
-----XX-X---[]--------XX-X-
-----X--X---[]-E-EE---XX-X-
-----X--X--XXXXXXXXXXXXX-X-