-------------------------
-------------------------
-------------------------
-------------------------
-------------------------
-------------------------
-------------------------
-------------------------
-------------------------
-------------------X-----
------------------XXX----
---B-------------XXXX----
---b--E-EE-E----XXXX-----
-XXXXXXXXXXXXXXXXXXX---XX