------------------------------
------------------------------
------------------------------
------------------------------
------------------------------
------------------------------
------------------------------
------------------------------
------------------------------
-------------------------E-XX-
--XX-----XX---------<-<-<>-XX-
--------------------[-[-[]-XXX
----------------EE--[-[-[]-XXX
X---X-XX---X-XXXXXXXXXXXXXXXXX