-------------------------
-------------------------
-------------------------
-------------------------
-------------------------
---------------SS--------
-------------------------
-------------------------
-------------------------
--E-----------XXXX----E--
-<>--------XXXXX-----<>--
-[]-----XXXXXX-------[]--
-[]----XXXXX---------[]--
XXXXXXXXXX------XX--XXXXX