------------------------------
------------------------------
------------------------------
------------------------------
------------------------------
------------------------------
--------------o--------<------
-----------------------[------
-----------------------X------
------------------------------
------------------------------
------------------------------
-EE---EE-----XXXX--------EE---
XXXXXXXXXX---------XXXXXXXXXXX