------------------------------
------------------------------
------------------------------
------------------------------
------------------------------
---------------------------XX-
---------------------------XX-
---------------X-----------XX-
---------------X--------XX-XX-
------------XX-X-------XXX-XX-
------------XX-X------XXXX-XX-
------------XX-X-----XXXXX-XX-
E-E---------XX-X----XXXXXX-XX-
XXXX---XXXXXXX-X--XXXXXXX--XXX