-------------------------
-------------------------
-------------------------
-------------------------
-------------------------
-SSSS---SSSSSSSSSSSSSSS--
-------------------------
-------------------------
--E----------------------
SSSSS--------------------
---------E---------------
--------<>---------------
--------[]---------------
XXXXXXXXXXXXXXXXXX------X