---------------------------
---------------------------
--------?------------------
---------------------------
---------------------------
-----------------XXX-------
----------SS----XXXX-------
---------------XXXXX-------
------SS------XXXXXX-------
-E-----------XXXXXXX-------
<>----------XXXXXXXX-------
[]---------XXXXXXXXX-------
[]--------XXXXXXXXXX-------
XXXXXXXXX-XXXXXXXXXXXXXXXXX