------------------------------
------------------------------
------------------------------
------------------------------
------------------------------
--?---?----?---?------SS-S----
------------------------------
------------------------------
------------------------------
--Q---Q----Q---Q--------------
------------------------------
------------------------------
------------------------E-E---
XXXXXXXXXXXXXXXXXXXXXXXXXXXXXX