--------------------------
--------------------------
--------------------------
--------------------------
--------------------------
----------------XX--------
----------------XX--------
-------------XX-XX--------
o------------XX-XX--------
------XX-----XX-XX--------
------------XXX-XX--------
------------XXX-XX--------
------------XXX-XX--------
--X-------XXXXX-XXXXXXXXXX