-------------------------
-------------------------
-------------------------
-------------------------
-------------------------
-------------------------
-------------------------
-------------------------
oo---------------E-------
----------------<>----E--
----------------[]---<>--
----------------[]---[]--
----------------[]---[]--
---XXXXX----XXXXXXXXXXXXX