------------------------------
------------------------------
------------------------------
------------------------------
------------------------------
-----------------oo-----------
------------------------------
-----------------------------o
------------------------------
---------------XX--XXX---XXX--
------X------------------XXX--
------X------------------XXX--
------X--XXXX------------XXX--
--XXXXX------------------XX---