------------------------------
------------------------------
------------------------------
------------------------------
------------------------------
---SSS------SSS---------S-S---
------------------------------
------------------------------
------------------------S-S---
S-----S--S-----S--------------
------------------------------
------------------------------
---------------------------E--
XXXXX-XXXXXXXX-XXXXXX-X----XX-