------------------------------
------------------------------
------------------------------
------------------------------
--------------------------oo--
--------------------------XX--
------------------------------
------------------------------
------------------------------
------------------------------
---X-----X---------X---XX?----
------------------------------
E---E-E---E---E-----E---------
XXX-XXXXX-XXXXXXXXX-XXX--XXX-X