------------------------------
------------------------------
------------------------------
------------------------------
------------------------------
------------------------------
------------------------------
-----------------------X------
----------------------XX------
---------------------XXX------
--------------------XXXX------
-X---X---X-X---X---XXXXX------
-X---X--XX-X---X--XXXXXX------
XXXXXXXXXXXXXXXXXXXXXXXXXXXXXX