------------------------------
------------------------------
------------------------------
------------------------------
------------------------------
------------------------------
------------------------------
------------------------------
------------------------------
---<-----<--------------------
---[-----[--------------------
---[-----[--------------------
E-E[E-E-E[E----E-E-E-EE---XX-X
XXXXXXXXXXXXXXXXXXXXXXXX------