------------------------------
------------------------------
------------------------------
------------------------------
-------------------------E----
---SSS---SSSQ-----S---SSSSS---
------------------------------
------------------------------
------------------------------
------------S-----------------
------------------------------
------------------------------
-------------E----------------
XXXXXXXXXXXXXXXXXXXXXXXXXXXXXX