------------------------------
------------------------------
------------------------------
------------------------------
------------------------------
-------------SSSSS------------
-----------------------------X
----------------------------XX
---------------------------XXX
------<>------------------XXXX
------[]-----------------XXXXX
------[]-------------<>-XXXXXX
-E----[]--X----------[]XXXXXXX
XXXXXXXXXXXXXXX----XXXXXXXXXXX