-------------------------
-------------------------
-------------------------
-------------------------
------ooo----------------
------XXX----------------
-------------------------
-------------------------
-------------------------
-------------------------
--XXX?-------------------
-------------------------
--------------E----------
X----XXXX-XXXXXXXXXXXXXXX