------------------------------
------------------------------
------------------------------
------------------------------
------------------------------
----------------SQQS----------
------------------------------
------------------------------
---------o--------------------
-----------------SS-----------
------X-----------------------
------X-----------------------
------X--------E-E----E-E-E-EE
-XXXXXX------XXXXXXXXXXXXXXXXX