--------------------------
--------------------------
--------------------------
--------------------------
---------------Eoo--------
-----------E---XXXX-------
--------------------------
---XX--XX-----------------
---XX------------------XX-
-XXXX--------XXXXXXX------
-XXXX---------------------
-XXXX----------------o----
-XXXX-----ooo-------XXX---
-XXXX-----XXX-------------