------------------------------
------------------------------
------------------------------
------------------------------
------------------------------
------------------------------
------------------------------
-------------------------XX---
-----oo-----------------XXX---
--E------------E--------XXX---
-<>---------XX<>------XXXXX---
-[]--------XXX[]-----XXXXXX---
-[]-------XXXX[]-E------XXX---
XXX-----XXXXX-XXXXXXXXXXXX--XX