-----------------------
-----------------------
-----------------------
-----------------------
--------------------oo-
------------E----------
-----------------------
-------XXX-------------
-----------------------
--------------XXXX---XX
-----------------------
-----------------------
-----------ooo---------
-XXXX------XXX---------