------------------------------
------------------------------
------------------------------
------------------------------
------------------------------
---SSS------SSS---------------
------------------------------
------------------------------
---SSS------SSS---------------
------------------------------
-------------------------E----
------------------------<>----
E-----E-EE-----E-E-E----[]----
XX----XXXXX----XXXXXXXXXXXXXXX