------------------------------
------------------------------
------------------------------
------------------------------
------------------------------
---S---SSS---S---SSSS-S-------
------------------------------
------------------------------
------------------------------
----------------------------X-
----------------------------XX
----------------------------XX
----------------------------XX
XXXXXXXXX-XXXXXXXXX-----XX--XX