------------------------------
------------------------------
------------------------------
------------------------------
------------------------------
------------------------------
------------------------------
------------------------------
----------------------X-------
---------------------XX-------
---XX------XX------EXXX----XXX
-------------------XXXX-------
E----E-EE----E-E--XXXXX-------
XXX--XXXXXX--XXXXXXXXXXXXXX---