-------------------------
-------------------------
-------------------------
-------------------------
-------------------------
-------------------------
--------E--E----E--------
--XXXXXXXXXXXXXXXXXXXXXX-
-------------------------
-------------------------
-------------------------
-------------------------
-------------------------
-------------------------