------------------------------
------------------------------
--------------oo--------------
------------------E-----------
----Eoo----------XXXX---------
----XXXX-------------------E--
------------------------------
-----------------------XX-----
------------XXXXX-------------
-XXXXXXXX--------------------X
------------------------------
----------o-------------------
---------XXX--------------ooo-
--------------------------XXX-