------------------------------
------------------------------
------------------------------
------------------------------
------------------------------
------------------------------
------------------------------
------------------------------
------------------------------
---------------S--------------
-----------------------------E
------------------------<---<>
E-EEE-E-EEE-E-EE--E-----[---[]
XXXXXXXXXXXXXXXXXXXXXXXXXXXXXX