----------------------------
----------------------------
----------------------------
----------------------------
----------------------------
--S-------SSS-----SSSSSSS---
----------------------------
-----------------E----------
-E-EE-----------------------
-----XX-XX-----S?S----------
-----XX-XX-----------------E
-----XX-XXX-----------------
-----X--XXX-----------------
-----X--XXXXXXXXXXXXXX----X-