------------------------------
------------------------------
------------------------------
------------------------------
------------------------------
--SS------SS---------SS-S-----
------------------------------
------------------------------
------------------------------
------------------------------
-----------------------------X
------------------------------
------------------E-----------
XX---XXXXX---XXXXXXXX-----XXX-