-----------------------------
-----------------------------
-----------------------------
-----------------------------
-----------------------------
----------------------SS-----
-----------------------------
------oo---------------------
-------------------SSS----oo-
--XXX------------------------
--XXX------------------------
X-XXX------------------------
X-XXX------------------------
X-XX---XXX-XXXXXXXXXXXX-X----