------------------------------
------------------------------
------------------------------
------------------------------
------------------------------
------------------------------
------------------------------
------------------------------
------------SS----------------
------------------------------
------------------------------
------------------------------
E-EEE-EE--------E-E-E-EEE-E-EE
XXXXXXXXXXXXXXXXXXXXXXXXXXXXXX