------------------------------
------------------------------
------------------------------
------------------------------
------------------------------
--------------------------S---
------------------------------
------------------------------
---E-------E------E-E----E-EEE
--<>------<>-----<>->---------
--[]------[]-----[]-]---------
--[]------[]-----[]-]---------
E-[]--E-E-[]--E-E[]-]---------
XXXXXXXXXXXXXXXXXXXXXXX-------