------------------------------
------------------------------
------------------------------
------------------------------
------------------------------
-----------SSSSSS-----------S-
------------------------------
-----------------------X------
-----------------------X---E-E
--------------------XX-X------
--------------------XX-X------
--------------------XX-X------
--------------------XX-X------
-XXX--X--XXXX-----XXXX-X------