------------------------------
------------------------------
------------------------------
------------------------------
--------------Eoo-------------
SQS-----------XXXX----------SS
------------------------------
------------------------------
----------------------XX------
S?S---------XXXXXXX-----------
---------E--------------------
--------------------o---------
-------------------XXX--------
XXXXXXXXXXXX--------------XXXX