------------------------------
------------------------------
-----------------------?------
------------------------------
------------------------------
------------------------------
-------------------------SS---
------------------------------
-oo------------------SS------X
------XXX-X-------X---------XX
------XXX-X------XX--------XXX
------XXX-X-----XXX-------XXXX
------XX--X----XXXX------XXXXX
----XXXX--X--XXXXXXXXXXX-XXXXX