------------------------------
------------------------------
------------------------------
------------------------------
------------------------------
-------------S----------------
-----------------------------X
----------------------------XX
-------E----E-EE-----------XXX
------<>--------XX-X-------XXX
------[]--------XX-X-----XXXXX
------[]--------XX-X----XXXXXX
------[]--------X--X-------XXX
-XXXXXXXXX------X--X--XXXXXXXX