------------------------------
------------------------------
------------------------------
------------------------------
------------------------------
---SS---SS---SS---SSSS--------
------------------------------
------------------------------
------------------------------
------------------------------
------------------------------
------------------------------
------------------------------
XXXXXXXXXXXXXXXXXXXX---XXXXXXX