------------------------------
------------------------------
------------------------------
------------------------------
------------------------------
----------S--------------SSSSS
------------------------------
---X--------------------------
---X-----E-EE-----------------
-X-X---------XX-X-------X-----
-X-X---------XX-X----X--X-----
-X-X---------XX-X----X--X-----
-X-X---------X--X----X--X-----
-X-X---------X--X--XXXXXXXX---