------------------------------
------------------------------
------------------------------
------------------------------
------------------------------
------------------------------
------------------------------
------------oo----------------
-----o------------------------
--------XXX-------------------
--------XXX-------------------
--------XXX-------------------
--------XXX------------E-E----
--XX----XX---XXXXX-XXXXXXXXXXX