------------------------------
------------------------------
------------------------------
------------------------------
------------------------------
--SS-------SS-----------S-SS--
------------------------------
------------------------------
------------------------------
------------------XX----------
------------------------------
------------------------------
------------------------------
XX--XXXXXXX--XXXXX----XX-X--XX