-------------------------
-------------------------
-------------------------
-------------------------
-------------------------
-------------------------
-ooooooooo---------------
-------------------------
-------------------------
-------------------------
-------------------------
-------------------------
-------------------E-----
-XXXXXXXXXXXXX--XXXXXXXXX