------------------------------
------------------------------
-----------oo-----------------
---------------E--E--E--------
--------------XXXXXXXXXX------
-------oo---------------------
------------------------------
---XX-------------------------
---XX---XXXXXX----------------
-XXXX-------------------------
-XXXX-------------------------
-XXXX-------------------------
-XXXX-------------------------
-XXXX---------------------XXXX