------------------------------
------------------------------
------------------------------
------------------------------
------------------------------
----S--------------------XX---
-------------------------XX---
-----------------------XXXX---
---E-EE----------------XXXX---
-------XX-X------------XXXX---
-------XX-X-----E-----XXXXX---
-------XX-X----<>-----XXXXX---
-------X--X----[]-----XXXXX---
-------X--X--XXXXXXXXXXXXXXXXX