------------------------------
------------------------------
------------------------------
------------------------------
------------------------------
------------------------------
------ooo-------ooo--------ooo
------------------------------
----E---------E----------E----
---<>--------<>-------<-<>----
---[]--------[]-------[-[]----
---[]--------[]-------[-[]----
---[]--------[]-------[-[]----
XXXXXXXXXXXXXXXXXXXXXXXXXXXXXX