------------------------------
------------------------------
------------------------------
------------------------------
-----------E------------------
------SSS--E------SSSS----SSS-
-------------XXX--------------
------------------------------
------------------------------
-----XXXXX-----------ES--XXXXX
-----X--------------<>---X----
-----X--------------[]---X----
-----X--------------[]---X----
XXXXXXXX------XXXXXXXXXXXXXX--