------------------------------
------------------------------
------------------------------
------------------------------
------------------------------
------------------------------
------------------------------
------------------------------
------------------------------
---------------X--------------
---------------XX-------------
---------------XXX------------
---XX-----XX---XXXX------XX---
X----X-X----X--XXXXXX-X----X--