------------------------------
------------------------------
------------------------------
------------------------------
------------------------------
--SS--SS----SS--SS--------S-SS
------------------------------
------------------------------
-----------------------E------
----------------------<>------
----------------------[]------
----------------------[]------
----------------------[]------
XX--XX--XXXX--XX--XXXXXXXX-X--