------------------------------
------------------------------
------------------------------
------------------------------
------------------------------
--S----------------XXXX-------
------------------XXXXX-------
-----------------XXXXXX-------
-E-EE-----------XXXXXXX-------
-----XX-X-------XXXXXXX-------
-----XX-X-----XXXXXXXXX-------
-----XX-X----XXXXXXXXXX----<>-
-----X--X-------XXXXXXX----[]X
-----X--X--XXXXXXXXXXXXXXXXXXX