------------------------------
------------------------------
------------------------------
------------------------------
------------------------------
---SSS------SSS-----------SSSS
------------------------------
------------------------------
---SSS------SSS-------X---SSSS
---------------------XX-------
--------------------XXX-------
-------------------XXXX-------
E--------E--------XXXXX-------
XX----XXXXX----XXXXXXXXXX-----