------------------------------
------------------------------
------------------------------
------------------------------
---oo-------------------------
-----------SSSSSSS------------
------------------------------
------------------------------
-----------SSSSSSS---oo-------
----XXX-----------------------
------------------------------
------------------------------
------------------------------
X--------X--------XXXXXXXXXXXX