-----------------------
-----------------------
-----------------------
-----------------------
-----------------------
----------------XX-----
----------------XX-----
----------------XX-----
-o-----------XX-XX-----
------------XXX-XX-----
----E------XXXX-XX-----
----------XXXXX-XX-----
---------XXXXXX-XX-----
---X-XXXXXXXXX--XXXXXXX