------------------------------
------------------------------
------------------------------
------------------------------
----------E-------------------
---------SQS-----------------Q
------------------------------
-------------------X----------
------------------XX----------
---------SQS-----XXX------QQQ?
----------------XXXX----------
---------------XXXXX----------
--------------XXXXXX----------
XXXXXXXXXXXXXXXXXXXXXXXXXXXXXX