------------------------------
------------------------------
------------------------------
------------------------------
------------------------------
--S-------SSSSS-----SSSSSSSSS-
------------------------------
------------------------------
-E-EE-------------------------
-----XX-XX--------------------
-----XX-XX--------------------
-----XX-XXX-------------------
-----X--XXX-------------------
-----X--XXXXX---X-XXXX--------