-------------------------
-------------------------
-------------------------
-------------------------
-------------------------
----SSSSS----------------
-------------------------
-------------------------
-------------------------
---SSSSSS----------------
-------------------------
------------------------<
------------------------[
XXXXXXXXXXXXXXXXXXXXXXXXX