-------------------------
-------------------------
-------------------------
-------------------------
-------------------------
-------------------------
-------------------------
-------------------------
-------------------------
-------E-----------------
------<>-----------------
------[]-----------------
------[]-----------------
XXXXX-XXXXXXXXXXXXXXXXXXX