------------------------------
------------------------------
------------------------------
------------------------------
---oo---Eooo------------------
--------XXXXX-----------------
------------------------------
------------------------------
-----------------XX------oo---
----XXXXXXXXXX----------------
------------------------------
---------------o--------------
--------------XXX------------X
X--------------------XXX------