------------------------------
------------------------------
------------------------------
------------------------------
--------------------------oo--
--------------------------XX--
------------------------------
------------------------------
-------------oo---------------
------------------------------
--XX----XX-------XXXX--XX?----
------------------------------
------------------------------
X---X-X---X----------X---XXX-X