------------------------------
------------------------------
------------------------------
------------------------------
------------------------------
------------------------------
------------------------------
------------------------------
------------------------------
------------------------------
-----------------------------E
----------------------------<>
---XX------XX---E---XXXX----[]
X------XX------XXX--------XXXX