---------------------------
---------------------------
---------------------------
---------------------------
---------------------------
SSSSS------------XX------SS
----------------XXX--------
---------------XXXX-----E--
SSSSS---------XXXXX--------
-------------XXXXXX---S?S--
------------XXXXXXX--------
-----------XXXXXXXX--------
----------XXXXXXXXX--------
-----XX-XXXXXXXXXXXXXXXXXXX