-----------------------------
-----------------------------
-----------------------------
-----------------------------
-----------------------------
---SS--------------SSSSS---SS
-----------------------------
-----------------------------
--------E--------------------
-------<>-------E------------
-------[]------<>------------
-------[]------[]------------
-----E-[]------[]------------
XXXXXXXXXXXXXXXXXXXXX----XXXX