---------------------------
---------------------------
---------------------------
---------------------------
---------------------------
---------------------------
---------------------------
-----oo----------XSS--o----
----------------XXX--------
-XXX-----------XXXX-SS-----
-XXX----------XXXXX--------
-XXX---------XXXXXX--SSS---
-XXX--------XXXXXXX--------
-XX---XXX-XXXXXXXX------XXX