------------------------------
------------------------------
------------------------------
------------------------------
------------------------------
------------------------------
------------------------------
------------------------------
------------------------------
------------Q---------------X-
---------------------------XXX
--------------------------XXXX
-E-E---E-E-----E-E-E--E--XXXXX
XXXXXXXXXXXXXXXXXXXXXXXXXXXXXX