------------------------------
------------------------------
------------------------------
------------------------------
------------------------------
-------S----------------------
------------------------------
------------------------------
------E-EE---------oo---oo----
-SS-------XX-X----------------
----------XX-X----------------
----------XX-X----------------
----------X--X----------------
-XXX------X--X--XX----X----XXX