------------------------------
------------------------------
------------------------------
------------------------------
------------------------------
------------------------------
------------------------------
------------------------------
---E------E-------E----E------
--<>-----<>------<>---<>------
--[]-----[]------[]---[]------
--[]-----[]------[]---[]------
--[]-----[]------[]---[]------
XXXXXXXXXXXXXXXXXXXXXXXXXXXXXX