--------------------------
--------------------------
--------------------------
--------------------------
--------------------------
----------------SSSSSSS---
--------------------------
---------------E----------
--------------------------
-------------S?S----------
---------EE--------------E
--------------------------
--------------------------
-XXXXXXXXXXXXXXXXXXX----X-