------------------------------
------------------------------
------------------------------
------------------------------
--------E---------------------
--------E--E----------------XX
----------XXXX--------------XX
--------------------------XXXX
--------------------------XXXX
--E--XX-------------------XXXX
-<>----------------E-----XXXXX
-[]---------------<>-----XXXXX
-[]---------------[]-----XXXXX
-XXXX-----------XXXXXXXXXXXXXX