------------------------------
------------------------------
------------------------------
------------------------------
------------------------------
----------------------SSSSSSSS
----E-------------------------
---<>-------------------------
---[]---------------SS--------
---XX------X------------------
-----------X------------------
------B----X------------------
------b----X------------------
--XXXXXXX--X--XX--XXXXX-------