-------------------------
-------------------------
-------------------------
-------------------------
-------------------------
-------------------------
-------------------------
-------------------------
-------------------------
-------------------------
-------------------------
-------------------------
-EE--------------E------E
XXXXXXXXXXXXXXXXXXXXXXXXX