-------------------------
-------------------------
-------------------------
-------------------------
-------------------------
---------SSQ-----?-------
-------------------------
-------------------------
-------------------------
-----------S-----Q-------
-------------------------
-------------------------
------------E------------
XXX--XXXXXXXXXXXXXXXXXXXX