------------------------------
------------------------------
------------------------------
------------------------------
------------------------------
--S---------------------------
------------------------------
------------------------------
-E-EE------------XSS-SQ-------
-----XX-X-------XXX-----------
-----XX-X------XXXX-----------
-----XX-X-----XXXXX---------X-
-----X--X----XXXXXX--SSSSS--X-
-----X--X--XXXXXXX-------XX-X-