-----------------------------
-----------------------------
-----------------------------
-----------------------------
----------------E------------
--S------------SQS-----------
-----------------------------
-----------------------------
-E-EE------------------------
-----XX-X------SQS-----SSQS--
-----XX-X--------------------
-----XX-X----X---------------
-----X--X----X---------------
-----X--X--XXXXXXXXXXXXXXXXXX