-------------------------
-------------------------
------?------------------
-------------------------
-------------------------
---------------XXX-------
--------SS----XXXX-------
-------------XXXXX-------
----SS------XXXXXX-------
-----------XXXXXXX-------
----------XXXXXXXX-------
---------XXXXXXXXX-------
--------XXXXXXXXXX-------
XXXXXXX-XXXXXXXXXXXXXXXXX