------------------------------
------------------------------
------------------------------
------------------------------
---oo---oo--------------------
--------------------XX--------
--------------------XX--------
-----------------XX-XX--------
-----------------XX-XX--------
----XXXX---------XX-XX--------
----------------XXX-XX-----B--
---------XXX----XXX-XX-----b--
----------------XXX-XX-----B--
X-------------XXXXX-XXXXXXXXXX