------------------------------
------------------------------
------------------------------
------------------------------
------------------------------
----------------------------S-
------------------------------
------------------------------
---E--------E-----E--------E--
--<>----<--<>----<>-----------
--[]----[--[]----[]-----------
--[]----[--[]----[]-----------
E-[]E-E-[E-[]E-E-[]-----------
XXXXXXXXXXXXXXXXXXXXXXXXX----X