---------------------------
---------------------------
---------------------------
---------------------------
---------------------------
SS---------------SSSSSSS---
---------------------------
----------------E----------
SS-------------------------
--------------S?S----------
-----------E--------------E
---------------------------
----X---E------------------
--XXXXXXXXXXXXXXXXXXX----X-