------------------------------
------------------------------
------------------------------
------------------------------
------------------------------
--?---?----?--?---?----?-----?
------------------------------
------------------------------
------------------------------
--Q---Q----Q--Q---Q----Q-----Q
------------------------------
------------------------------
------------------------------
XXXXXXXXXXXXXXXXXXXXXXXXXXXXXX