--------------------------
--------------------------
--------------------------
--------------------------
--------------------------
---------------------XX---
--------------------XXX---
-------------------XXXX---
------------------XXXXX---
-----------------XXXXXX---
----------------XXXXXXX---
---------------XXXXXXXX---
E-E--XX-------XXXXXXXXX--X
XXXXXXXXXXX-XXXXXXXXXXXXXX