------------------------------
------------------------------
----------------------oo------
--------------------------E---
-------------------------XXXX-
----S-------------oo----------
------------------------------
------------------------------
---E-EE------------XXXXXX-----
-------XX-X-------------------
-------XX-X-------------------
-------XX-X-------------------
-------X--X-------------------
-------X--X--XXX--------------