------------------------------
------------------------------
------------------------------
------------------------------
------------------------------
--------SS--------------------
------------------------------
------------------------------
--------SS---o----------------
------------------------------
--------------------------E---
-------------------------<>---
----E--------------XX----[]---
XXXXXXX---XX---XX------XXXXXX-