------------------------------
------------------------------
------------------------------
------------------------------
------------------------------
---------SSS-------XXX--------
-------------------XXX--------
-----oo----------X-XXX--------
-----------------X-XXX-------X
-XXX-----------X-X-XXX------XX
-XXX-----------X-X-XXX-----XXX
-XXX-----------X-X-XXX----XXXX
-XXX-----------X-X-XXX---XXXXX
-XX---XXXXX-X--X-X-XXXXXXXXXXX