-----------------------------
-----------------------------
-----------------------------
-----------------------------
-----------------------------
--------------S--------------
-----------------------------
----------------------X------
-------------E-EE-----X------
------ESS--------XX-X-X------
-----------------XX-X-X------
-----------------XX-X-X-----X
--E--------------X--X-X-----X
XXXXXXXXXXX------X--X-X---X-X