------------------------------
------------------------------
------------------------------
------------------------------
------------------------------
--SQQ--SQQS---SQQ--SQQS-------
------------------------------
------------------------------
------------------------------
---SS---SS-----SS---SS----S-S?
------------------------------
------------------------------
-E-E--E-E----E-E--E-E---------
XXXXXXXXXXXXXXXXXXXXXXXXXXXXXX