------------------------------
------------------------------
------------------------------
------------------------------
--------------------------E---
-----------E------E-------E--E
----------<>-----XXXX-------XX
----------[]------------------
------o---[]------------------
----------XXX----------XX-----
------------------------------
------------------------------
EE-E------E-------------------
XXXXX---XXXXXXX---------------