------------------------------
------------------------------
------------------------------
------------------------------
---------------------------oo-
------------------SS-------XX-
------------------------------
------------------------------
------------------SS----------
------------------------------
--XX--X----XX--X------XXXX?---
------------------------------
------------------------------
X---X--X-X---X--X---XX----XXX-