------------------------------
------------------------------
------------------------------
------------------------------
------------------------------
-----S------S---------------S-
------------------------------
------------------------------
----E-E----E-EE------------E-E
---------------XX-X-----------
---------------XX-X-----------
---------------XX-X-----------
---------------X--X-----------
XX-----XX------X--X--X-XX-----