------------------------------
------------------------------
------------------------------
------------------------------
------------------------------
---------------------SS-------
------------------------------
------------------------------
--o---------------------------
--------E-----------XXXX----E-
-------<>--------XXXXX-----<>-
-------[]-----XXXXXX-------[]-
-------[]-E--XXXXX---------[]-
----X--XXXXXXXXX------XX--XXXX