------------------------------
------------------------------
------------------------------
------------------------------
------------------------------
---------S--------------------
------------------------------
------------------------------
--------E-EE---------oo---oo--
----S-------XX-X--------------
------------XX-X--------------
------------XX-X--------------
---E--------X--X--------------
-XXXXX------X--X--XX----X----X