------------------------------
------------------------------
------------------------------
------------------------------
------------------------------
------------------------------
------------------------------
------------------------------
------------------------------
------------------------------
------------------------------
---B-------B------------B-----
E--bE-E-E--bE-E----E-E--bE-E--
XXXXXXXXXXXXXXXXX-XXXXXXXXXXXX