------------------------------
------------------------------
------------------------------
------------------------------
------------------------------
--------------------SSS-------
------------------------------
------------------------------
------------------------------
------------------------------
------------------------------
------------------------------
E-EE--EE--E-EE--EE-----EEEE--E
XXXXXXXXXXXXXXXXXXXXXXXXXXXXXX