-------------------------
-------------------------
-------------------------
-------------------------
-------------------------
-------------------------
-------------------------
-------------------------
------------E------------
-SSS-------<>------------
------E----[]------------
-----<>----[]------------
-----[]----[]---E--------
-XXXXXXXXXXXXXXXXXXXXXXXX