--------------------------
--------------------------
--------------------------
--------------------------
--------------------------
----SSSSS---------SSSSS---
--------------------------
--------------------------
--------------------------
-E-X-------------X--------
<>-X----------X--X--------
[]-X----------X--X--------
[]-X-------E--X--X--------
XXXXXXX---XXXXXXXXXX----XX