------------------------------
------------------------------
------------------------------
------------------------------
------------------------------
------------------------------
------------------------------
------------------------------
---E-----E------------E----E--
--<>----<>---------<-<>---<>--
--[]----[]---------[-[]---[]--
--[]----[]------X--[-[]---[]--
--[]----[]---EE-X--[-[]---[]--
XXXXXXXXXXXXXXXXXXXXXXXXXXXXXX