------------------------------
------------------------------
------------------------------
------------------------------
------------------------------
------------------------------
------------------------------
------------------------------
------------------------------
---X-----X--------X-X---X-----
---XX----XX------XX-X---XX----
---XXX---XXX----XXX-X---XXX---
---XXX---XXXX--XXXX-X---XXX---
X--XXXX--XXXXXXXXXXXXX--XXXX--