-------------------------
-------------------------
-------------------------
-------------------------
---oo--------------------
------------------XX-----
------------------XX-----
------------------XX-----
---------------XX-XX-----
----XXX-------XXX-XX-----
-------------XXXX-XX-----
------------XXXXX-XX-----
-----------XXXXXX-XX-----
X--------XXXXXXX--XXXXXXX