---------------------------
---------------------------
---------------------------
---------------------------
---------------------------
------------SSSSSSSSS------
---------------------------
--------oo----------------<
--------------------------[
----XXX-------------------X
----XXX--------------------
----XXX--------------------
----XXX--------------------
XXXXXX---XXXXX--------XXXXX