------------------------------
------------------------------
------------------------------
--XX----XX--------------------
--XX----XX--------------------
--XX----XX----------SS?S?SSS?S
--XX----XX--------------------
--XX----XX--------------------
--XX----XX--------------------
--XX----XX----------SSSSSSSSSS
--XX----XX--------------------
--XX----XX--------------------
--XX----XX--E-----------------
XXXXXXXXXXXXXXXXXXXXXXXXXXXXXX