------------------------------
------------------------------
------------------------------
------------------------------
------------------------------
----SSS-----SSS---------------
------------------------------
---E-------E------------------
------------------------------
-S?S-----S?S---------Q--------
------------------------------
------------------------------
-------E-------EE-------EEEE--
XXXXXXXXXXXXXXXXXXXXXXXXXXXXXX