------------------------------
------------------------------
------------------------------
------------------------------
----Eoo-----------------------
----XXXX----------------XXX---
-----------------------XXXX---
----------------------XXXXX---
------------XX-------XXXXXX---
-XXXXXXXX------------XXXXXX---
-------------------XXXXXXXX---
----------o-------XXXXXXXXX---
---------XXX---------XXXXXX---
----------------XXXXXXXXXXXXXX