-------------------------
-------------------------
-------------------------
-------------------------
-------------------------
-------------XXX---------
-------------XXX---------
----------XX-XXX---------
----o-----XX-XXX---------
----------XX-XXX------E--
---------XXX-XXX-----<>--
---------XXX-XXX-----[]--
---------XXX-XXX-----[]--
-XXXXXXXXXXX-XXXXXXXXXXXX