------------------------------
------------------------------
------------------------------
------------------------------
------------------------------
--------------------SS--------
------------------------------
------------------------------
---------S--------------------
------X------------XXXX-------
-----XX---------XXXXX---------
----XXX------XXXXXX-----------
---XXXX-----XXXXX-------------
-XXXXXXXXXXXXXX------XX---X--X