------------------------------
------------------------------
------------------------------
------------------------------
------------------------------
---SSS----SSS-----SSS----SSS--
------------------------------
------------------------------
------------------------------
------------------------------
------------------------------
------------------------------
------------------------------
XXXXXXXXXXXXXXXXXXXXXXXXXXXXXX