--------------------------
--------------------------
--------------------------
--------------------------
--------------------------
--------------------------
--------------------------
------------------------X-
oo----------------------X-
------E-----E--------XX-X-
-----<>--<-<>--------XX-X-
-----[]--[-[]--------XX-X-
-----[]--[-[]-E-EE---XX-X-
----XXXXXXXXXXXXXXXXXXX-X-