------------------------------
------------------------------
------------------------------
------------------------------
------------------------------
------------------------------
------------------------------
------------------------------
------------------------------
---X------X-----<>------------
---X------X-----[]------------
---X------X-----[]------------
---X------X-----[]------------
X--XX--X--XX--XXXXXXX-X--X--XX