----------------------------
----------------------------
----------------------------
----------------------------
----------------------------
--S------------------------X
--------------------------XX
-------------------------XXX
-E-EE-------------------XXXX
-----XX-X----QQ--------XXXXX
-----XX-X-------------XXXXXX
-----XX-X------------XXXXXXX
-----X--X---------XXXXXXXXXX
-----X--X--XXXXXXXXXXXXXXXXX