-----------------------------
-----------------------------
-----------------------------
-----------------------------
-----------------------------
-------------------XXX-------
------------------XXXX-------
-----------------XXXXX-------
-------o--------XXXXXX-------
----------------XXXXXX-------
--------------XXXXXXXX-------
-------------XXXXXXXXX-------
----E-----------XXXXXX-------
-XXXXX-----XXXXXXXXXXXXXXXXXX