------------------------------
------------------------------
------------------------------
------------------------------
------------------------------
---S---SSQ---S---SSQ----------
------------------------------
------------------------------
------------------------------
---------S---------S----------
------------------------------
------------------------------
--------------------E----E---E
XXXXXXXXXXXXXXXXXXXXXXXXXXXXXX