------------------------------
------------------------------
------------------------------
------------------------------
---------------oo-----E-------
----------------------E--E----
------------------------XXXXXX
------------------------------
o---------X-------------------
---------XX-----XXXXX---------
-----E--XXX-------------------
-------XXXX-------------------
------XXXXX-------------------
--XXXXXXXXXXX-----------------