------------------------------
------------------------------
------------------------------
------------------------------
------------------------------
-------------------XXXX-------
------------------XXXXX-------
----o------------XXXXXX-------
----------------XXXXXXX--?----
-SSS------------XXXXXXX-------
--------------XXXXXXXXX------E
-------------XXXXXXXXXX-------
-------E--------XXXXXXX-------
-XXXXXXXXX-XXXXXXXXXXXXXXXXXXX