--------------------------
--------------------------
--------------------------
--------------------------
--------------------------
---------------SS---------
--------------------------
--------------------------
--------------------------
--------------XXXX--------
--E--------XXXXX----------
--------XXXXXX------------
------XXXXXX--------------
-X-XXXXXXX------XX---X--XX