------------------------------
------------------------------
------------------------------
------------------------------
------------------------------
-------SSS-------XXX---------S
-----------------XXX----------
---------------X-XXX----------
---E-----------X-XXX--o-------
-E<>--XXXXX--X-X-XXX----------
<>[]--X------X-X-XXX----------
[][]--X------X-X-XXX---------<
[][]--X------X-X-XXX---------[
XXXXXXXXX----X-X-XXXXXXXX-XXXX