------------------------------
------------------------------
------------------------------
------------------------------
------------------------------
---SS---SS--------SSQSQ-------
------------------------------
------------------------------
------------------------------
--------------------S-S-------
------------------------------
------------------------------
----------EE-E-E-------E------
XXXXXXXXXXXXXXXXXXXXXXXXXXXXXX