------------------------------
------------------------------
------------------------------
------------------------------
------------------------------
------------------------------
---------------------XXX------
------------------------------
------------------------------
------------------------------
------------------------------
-----------------------------X
---XX---XXXXX----XX-------X-XX
X----X----------------XXXXXXXX