------------------------------
------------------------------
------------------------------
------------------------------
------------------------------
--?--------------XXXX---------
----------------XXXXX---------
---------------XXXXXX---------
--------S-----XXXXXXX---------
--Q-----------XXXXXXX---------
------------XXXXXXXXX--------X
-----------XXXXXXXXXX----<>-XX
--------------XXXXXXX----[]XXX
XXXXXXXXXXXXXXXXXXXXXXXXXXXXXX