------------------------------
------------------------------
------------------------------
------------------------------
------------------------------
--SS--S--SS--SS------SSSS--SSS
------------------------------
------------------------------
------------------------------
------------------E-----------
-----------------<>-----------
-----------------[]-----------
-----------------[]-----------
XX--XX-XX--XX---XXXXX----XX---