------------------------------
------------------------------
------------------SSSSSS------
------------------------------
------------------------------
------------------------------
------------------------------
------------------------------
------------------------------
----------------------QQ------
---XX-----XX------------------
------------------------------
E----E-E----E-E------------E-E
XXX--XXXXX--XXXXXXXXXXXX--XXXX