------------------------------
------------------------------
------------------------------
------------------------------
------------------------------
-------------XX-----E---------
-------------XX----XXXX-------
-------------XX-------------XX
----------XX-XX-------------XX
XSS------XXX-XX-------------XX
X-------XXXX-XX------------XXX
X------XXXXX-XX------------XXX
X-----XXXXXX-XX------------XXX
XXXXXXXXXXX--XXXX--------XXXXX