-------------------------
-------------------------
-------------------------
-------------------------
-------------------------
----------------------S--
-------------------------
-------------------------
o--------------------E-EE
-------------------------
-------------------------
-------------------------
----E---------E-EE-------
--XXXXXXXXXXXXXXXXX------