------------------------------
------------------------------
------------------------------
------------------------------
------------------------------
------------------------------
------------------------------
------------------------------
------------------------------
---X-------X-----------X------
---X-------X-----------X------
---X-------X-----------X------
---X-------X-----------X------
X--XX--XX--XX--XXXX-X--XX--X--