------------------------------
------------------------------
-------------?----------------
------------------------------
------------------------------
------E---------------XXX-----
---------------SS----XXXX-----
--------X-----------XXXXX-----
------EXX--SS------XXXXXX-----
-----<>XX---------XXXXXXX-----
-----[]XX--------XXXXXXXX-----
----X[]XX-------XXXXXXXXX-----
---XX[]XX------XXXXXXXXXX-----
XXXXXXXXXXXXXX-XXXXXXXXXXXXXXX