-------------------------
-------------------------
-------------------------
-------------------------
-------------------------
-------------------------
-XXX---------------------
-------------------------
------------E------------
-----------<>------------
-----------[]------------
-----------[]------------
-----------[]---E--------
--XXXX-XXXXXXXXXXXXXXXXXX