----------------------------
----------------------------
----------------------------
----------------------------
----------------------------
--S-------------------------
----------------------------
----------------------------
-E-EE------------oo---oo----
-----XX-XX--SS--------------
-----XX-XX------------------
-----XX-XX------------------
-----X--XX------------------
-----X--XX--XXXX----X----XXX