------------------------------
------------------------------
------------------------------
------------------------------
------------------------------
-----------SSS--SSSSSSSSSSSSS-
----E-------------------------
---<>-------------------------
---[]-------------------------
---XX----XX-------------------
---------XX-------------------
------B--XXX------------------
------b--XXX------------------
--XXXXXXXXXXXXXXXX------------