------------------------------
------------------------------
------------------------------
------------------------------
------------------------------
------------------------------
------------------------------
------------------------------
-E-----E----E-E----E----------
<>---<<>---<>->---<>--S-S-----
[]---[[]---[]-]---[]----------
[]---[[]---[]-]---[]----------
[]---[[]---[]-]---[]----------
XXXXXXXXXXXXXXXXXXXXXXXXXXXXXX