------------------------------
------------------------------
------------------------oo----
----------------------------E-
---------------------------XXX
--------------E-----oo--------
------------------------------
----------XX------------------
---------------------XXXXXX---
-----Q----------XX------------
------------------------------
------------------------------
-------------ooo--------------
X--XXXXX-----XXX--------------