------------------------------
------------------------------
------------------------------
------------------------------
---------------------oo-------
---------------------XX-------
------------------------------
------------------------------
------------------------------
-----------------E------------
---X---X---X---XXXXX?-----X-X-
------------------------------
E---E---E---E----------------E
XXX-XXX-XXX-XXX-----XXX-XX-X-X