------------------------------
------------------------------
------------------------------
------------------------------
----------E-----Eooo----------
--SQQS--SSSS----XXXXX---------
-----------------------------X
------------------------------
-------------------------XX---
---SS---SSSS--XXXXXXXX--------
------------------------------
-----------------------o------
-E-E------------------XXX-----
XXXXXXXXXXXXXX----------------