------------------------------
------------------------------
------------------------------
------------------------------
------------------------------
-----XX--------XX--------XX---
------------------------------
------------------------------
------------------------------
------------------------------
------------------------------
------------------------------
------------------------------
XXX----XXXXXX----XXXXXX----XXX