----------------------------
----------------------------
----------------------------
----------------------------
----------------------------
------------------XX--------
-----------E------XX--------
----------<>---XX-XX--------
----------[]---XX-XX--------
-E--------[]---XX-XX--------
<>------E-[]--XXX-XX--------
[]-----<>-[]--XXX-XX--------
[]-E---[]-[]--XXX-XX--------
XXXXXXXXXXXXXXXXX-XXXXXXXXXX