------------------------------
------------------------------
------------------------------
------------------------------
------------------------------
--------X-----------X---------
--------X-----------X---------
-----XX-X--------XX-X-------X-
-----XX-X--------XX-X-------X-
S----XX-XS--S----XX-XS------X-
----XXX-X-------XXX-X------XXX
----XXX-X-------XXX-X------XXX
----XXX-X-------XXX-X------XXX
XXXXXXX-XXXXXXXXXXX-XXXX-XXXXX