------------------------------
------------------------------
------------------------------
------------------------------
------------------------------
---------------------SSSS-----
------------------------------
------------------------------
----------------------E-------
--------------------SSSSSS--S-
------------------------------
------------------------------
---XX--------XX---------------
X------X--X------X--XXXXXXX-X-