------------------------------
------------------------------
------------------------------
------------------------------
------------------------------
-------------------------XXXX-
-------------------------XXXX-
-----X-----X-----X-----XXXXXX-
-----X-----X-----X-----XXXXXX-
S----XS----XS----XS----XXXXXX-
----XX----XX----XX----XXXXXXX-
----XX----XX----XX----XXXXXXX-
----XX----XX----XX----XXXXXXX-
XXXXXXXXXXXXXXXXXXXXXXXXXXXXXX