------------------------------
------------------------------
------------------------------
------------------------------
------------------------------
-SSS------------E-----E-------
---------------XXXX--XXXXX----
-----------XX-----------------
-----------XX-----------------
-SSS-------XX-----------------
----------XXX-----------------
----------XXX-----------------
----------XXX----------------E
XXXXXXXXXXXXX---------------XX