------------------------------
------------------------------
------------------------------
------------------------------
------------------------------
-----------------XXX----------
----------------XXXX----------
---------------XXXXX----------
--------------XXXXXX----o-----
--E-----------XXXXXX----------
-<>---------XXXXXXXX----------
-[]--------XXXXXXXXX----------
-[]-E---------XXXXXX----------
XXXXXX-X-XXXXXXXXXXXXXX-----XX