------------------------------
------------------------------
------------------------------
------------------------------
------------------------------
---SSS--------SSS------------S
------------------------------
------------------------------
---SSS--------SSS------------S
------------------------------
------------------------------
----------------------X-------
E-------EE-E-------EE-X-E-E---
XX----XXXXXXX----XXXXXXXXXXX--