------------------------------
------------------------------
------------------------------
------------------------------
--------E---------------------
--------E---------XXX--------X
----------XXX-----XXX-------XX
----------------XXXXX------XXX
----------------XXXXX-----XXXX
-----XX---------XXXXX-----XXXX
---------------XXXXXX---XXXXXX
---------------XXXXXX--XXXXXXX
EE-------------XXXXXX-----XXXX
XXXXX------XXXXXXXXXXXXXXXXXXX