------------------------------
------------------------------
------------------------------
------------------------XXXX-X
------------------------XXXX-X
----------------E-------XXXX-X
------------------------XXXX-X
-----------XXX----------XXXX-X
------------------------XXXX-X
------------------XX----XXXX-X
---XX---XXXX------------XXXX-X
------------------------XXXX-X
E----E---------ooo------XXXX-X
XXX--XXX-------XXX----XXXXXXXX