-----------------------------
-----------------------------
-----------------------------
-----------------------------
-----------------------------
-----------------E-----E-----
----------------XXXX--XXXX--X
-----XX----------------------
-----XX--o-------------------
-----XX----------------------
----XXX----------------------
----XXX----------------------
----XXX-----E----------------
X-XXXXX----XXX---------------