------------------------------
------------------------------
------------------------------
------------------------------
------------------------------
---------------------------SSS
------------------------------
------------------------------
------------------------------
------------------------------
------------------------------
------------------------------
---XX---XX----XX---XX---------
X----X-----X----X------XXXXXX-