-----------------------------
-----------------------------
--------------oo-------------
------------------E----------
-----------------XXXX--------
----------oo---------------E-
--E--------------------------
-<>--------------------XX----
-[]--------XXXXXX------------
-XXX--XX---------------------
-----------------------------
-----------------------------
--------------------------ooo
XXXXXX--------------------XXX