------------------------------
------------------------------
------------------------------
------------------------------
------------------------------
------------------E-----------
------------------------------
-------------XXX--------------
------------------------------
--------------------XX--------
--XXX--XXXXXXX----------------
------------------------------
-----------------ooo----------
X----X-----------XXX----XXXXXX