------------------------------
------------------------------
------------------------------
------------------------------
------------------------------
------------------oo----------
------------------------------
------------------------------
------------------------------
----------------XX--XX--------
------------------------------
------------------------------
E------E----------------------
XXXXXXXXXXXXXXXX--------XXXXXX