---------------------------
---------------------------
---------------------------
---------------------------
---------------------------
--S------------------------
---------------------------
---------------------------
-E-EE-------E--------------
-----XX-X--<>--------------
-----XX-X--[]-----------E--
-----XX-X--[]--------------
-----X--X--[]--------------
-----X--X--XX--XXX-----X-XX