-----------------------------
-----------------------------
-----------------------------
-----------------------------
-----------------------------
--S---------S----------------
-----------------------------
-----------------------------
-E-EE------E-EE--------------
-----XX-X------XX-X----------
-----XX-X------XX-X----------
-----XX-X------XX-X----------
-----X--X------X--X----------
-----X--X------X--X--XXX-----