------------------------------
------------------------------
------------------------------
------------------------------
------------------------------
------------------------------
---o---oo----------------o----
------------------------------
-E---E------------E-E--E---E-E
<>--<>----------E<><>-<>--<><>
[]--[]-------XX<>[][]-[]--[][]
[]--[]------XXX[][][]-[]--[][]
[]--[]-----XXXX[][][]-[]--[][]
XXXXXXXXXXXXXX-XXXXXXXXXXXXXXX