---------------------------
---------------------------
---------------------------
---------------------------
---------------------------
--------Q----------oo------
---------------------------
---------------------------
---------------------------
------S?SQS---XXXXX--XX----
-X-------------------------
-X-------------------------
-X-----E-------------------
-XXXXXXXXXXX-------------XX