------------------------------
------------------------------
------------------------------
------------------------------
------------------------------
-------------------------XX---
------------------------------
------------------------------
-----------------E---------XXX
----------------<>------------
----------------[]------------
----------------[]------------
----------------[]------------
XXX-XXXXXX-XXXXXXXXXXXX-------