------------------------------
------------------------------
------------------------------
------------------------------
------------------------------
-------------------------E----
------------------------XXXXXX
------------------------------
-------------------E----------
-----------------E<>----------
-------------E--<>[]----------
------------<>--[][]----------
-EE---------[]--[][]----------
XXXXXXXXXXXXXXXXXXXXXX--------