------------------------------
------------------------------
------------------------------
------------------------------
------------------------------
--S---------S-----------------
------------------------------
------------------------------
-E-EE------E-EE------------XX-
-----XX-X------XX-X-------XXX-
-----XX-X------XX-X------XXXX-
-----XX-X------XX-X-----XXXXX-
-----X--X------X--X----XXXXXX-
-----X--X------X--X--XXXXXXX--