------------------------------
------------------------------
------------------------------
------------------------------
------------------------------
--SQ----SQ-----------SQ--SQ---
------------------------------
------------------------------
------------------------------
---S-----S----<>------S---S---
--------------[]--------------
--------------[]--------------
-E-E-E-E-E-EE-[]--E-E-E-E-E-E-
XXXXXXXXXXXXXXXXXXXXXXXXXXXXXX