------------------------------
------------------------------
------------------------------
------------------------------
------------------------------
------------------------------
------------------------------
------------------------------
------------------------------
------------------------------
--------------------<-<-------
--------------------[-[-------
-EE-E-EE-EE-E-EE----[-[-EE-E-E
XXXXXXXXXXXXXXXXXXXXXXXXXXXXXX