------------------------------
------------------------------
-----------------oo-----------
---------------------E--------
--------------------XXXX------
-------------oo---------------
------------------------------
------------------------------
--------------XXXXXX--------SS
----------E-------------------
---------<>-------------------
E--------[]-------------------
---------[]-------------------
X-XXXXX-XXX---------------XXXX