------------------------------
------------------------------
------------------------------
------------------------------
------------------------------
------------------------------
-------------------XXX--------
------------------------------
------------------------------
------------------------------
---XX---X---XX---XXX----------
------------------------------
E----E---E----E----------E-E--
XXX--XXX-XXX--XXX-------XXXXXX