-------------------------
-------------------------
-------------------------
-------------------------
-------------------------
------------SQS----------
-------------------------
----o--------------------
-------------------------
--SS--------S?S--XSS-----
-----------------X-----E-
-----------------X-------
--------EE-E----EX-------
XXXXXXXXXXXXXXXXXXXXXXXXX