------------------------------
------------------------------
------------------------------
------------------------------
------------------------------
--S---------------------S-----
------------------------------
------------------------------
-E-EE------------------E-EE---
-----XX-XX--X-----XX-------XX-
-----XX-XX--XX----XX-------XX-
-----XX-XX--XXX---XX-------XX-
-----X--XX--XXXX--XX-------X--
-----X--XX--XXXXXXXX-------X--