------------------------------
------------------------------
------------------------------
------------------------------
------------------------------
SSS-----------------XXX-------
-------------------XXXX-------
------------------XXXXX-------
SSS--------------XXXXXX----o--
--------XX-------XXXXXX-------
--------XX-----XXXXXXXX-------
--------XX----XXXXXXXXX-------
--------XX-------XXXXXX-------
---XXXXXXX--XXXXXXXXXXXXXX----