------------------------------
------------------------------
------------------------------
------------------------------
------------------------------
-------------------E----------
--------------E---------------
------------XXXXX-------------
------------------------------
---------------------XX-------
------------------------------
------------------------------
---XX---XX--------ooo----XX-X-
X----X------------XXX---------