------------------------------
------------------------------
------------------------------
------------------------------
------------------------------
--------------------------SQQS
------------------------------
------------------------------
------------------------------
---------X-----------------SS-
---------XX-------------------
---------XXX------------------
---------XXXX------------E-E--
XXX-XXX--XXXXXXXXX--XXXXXXXXXX