------------------------------
------------------------------
------------------------------
------------------------------
------------------------------
-------------SSSSSSS----------
------------------------------
------------------------------
-------------SSSSSSS---oo-----
------X-----------------------
------XX----------------------
------XXX---------------------
------XXXX--------------------
XXXX--XXXXXX--------XXXXXXXXXX