------------------------------
------------------------------
------------------------------
------------------------------
---o---oo----o-oo-----o---oo--
------------------------------
------------------------------
------------------------------
------------------------------
--------XXX-----XXX--------XXX
------------------------------
------------------------------
------------------------------
X---X--------------X---X------