------------------------------
------------------------------
------------------------------
------------------------------
------------------------------
--S---------S-----------------
------------------------------
------------------------------
-E-EE------E-EE---------oo---o
-----XX-X------XX-X-----------
-----XX-X------XX-X-----------
-----XX-X------XX-X-----------
-----X--X------X--X-----------
-----X--X------X--X--XX----X--