------------------------------
------------------------------
------------------------------
------------------------------
------------------------------
------------------------------
------------------------------
------------------------------
------------------------------
------------------------------
------------------------------
------------------------------
E-EEEEEEEEE-E-EEEEEEEEE---EEEE
XXXXXXXXXXXXXXXXXXXXXXXXXXXXXX