------------------------------
------------------------------
-------------?----------------
------------------------------
------------------------------
----------------------XXX-----
---------------SS----XXXX-----
---X----------------XXXXX-----
---X-------SS------XXXXXX-----
-X-X--------------XXXXXXX-----
-X-X-------------XXXXXXXX-----
-X-X------------XXXXXXXXX-----
-X-X-----------XXXXXXXXXX-----
-X-X-----XXXXX-XXXXXXXXXXXXXXX