------------------------------
------------------------------
------------------------------
------------------------------
------------------------------
------------------------------
------------------------------
------------------------------
------------------------------
------------------------------
------------------------------
------------------------------
--------E----------E--------E-
XXXXXXXXXXXXXXXXXXXXXXXXXXXXXX