------------------------------
------------------------------
------------------------------
------------------------------
------------------------------
----------E--------------E----
---------<>-------------XXXXXX
---------[]-------------------
---------XXX-------E----------
-----------------E<>----------
-------------E--<>[]----------
------------<>--[][]----------
-E-E--------[]--[][]----------
XXXXXXXXXXXXXXXXXXXXXX--------