-------------------------
-------------------------
-------------------------
-------------------------
---oo--------------------
---XX------SSSSS----SSS--
-------------------------
-------------------------
-------------------------
---------------ES--XXXXX-
XX?-----------<>---X-----
--------------[]---X-----
--------E-----[]---X-----
--XXX-XXXXXXXXXXXXXXXX---