------------------------------
------------------------------
------------------------------
------------------------------
------------------------------
-------------------------E----
------------------------XXXXX-
-------X----------------------
------XX----------------------
-----XXX--XX------------------
----XXXX--XX------------------
---XXXXX--XX------------------
--XXXXXX--XX-------X----------
XXXXXXXXXXXX--XXXXXXXX--------