------------------------------
------------------------------
------------------------------
------------------------------
------------------------------
--S-----------------------XXX-
-------------------------XXXX-
------------oo----------XXXXX-
-E-EE------------------XXXXXX-
-----XX-XXX------E-----XXXXXX-
-----XX-XXX-----<>---XXXXXXXX-
-----XX-XXX-----[]--XXXXXXXXX-
-----X--XXX-----[]-----XXXXXX-
-----X--XX---XXXXXXXXXXXXXXXXX