------------------------------
------------------------------
------------------------------
------------------------------
------------------------------
-----S----------S--------S-S--
------------------------------
------------------------------
----E-EE-------E-EE-----E-E-EE
------------------------------
------------------------------
------------------------------
------------------------------
XX------XX-XX------XX---------