------------------------------
------------------------------
------------------------------
------------------------------
------------------------------
------------------------------
------------------------------
------------------------------
------------------------------
---X------X----S-------X------
---X------X------------X------
---X------X------------X------
---X------X------------X------
X--XX-XX--XX-XXXXXX----XX-XX--