------------------------------
------------------------------
------------------------------
------------------------------
------------------------------
------SS---------E------------
----------------XXXXXXX-------
------------------------------
------SS----------------------
------------------------------
------------------------------
------------------------------
EE-E----------------------EE-E
XXXXX---XXXXXX-----------XXXXX