------------------------------
------------------------------
------------------------------
------------------------------
---------------oo------Eoo----
---------XX------------XXXX---
---------XX-------------------
-------X-XX-------------------
-------X-XX-------------------
-----X-X-XX--XX------XXXXXXX--
-----X-X-XX-------------------
-----X-X-XX-----XXX----------o
-----X-X-XX-----------------XX
X-X--X-X-XXXX-----------------