------------------------------
------------------------------
------------------------------
------------------------------
------------------------------
-----S------S----------SSS-S--
------------------------------
------------------------------
----E------E------------------
------------------------------
------------------------------
------------------------------
----------------E---E---------
XX----XXX----X-XXXXXXXXXX-X-XX