------------------------------
------------------------------
------------------------------
------------------------------
------------------------------
-----------------XX--SSSSSSSSS
----------oo-----XX-----------
---------------XXXX-----------
---------------XXXX-----------
---------------XXXX-----------
--------X-----XXXXX-----------
-----B--X-----XXXXX-----------
E-E--b--X-----XXXXX-----------
XXXXXXXXXXXXXXXXXXXXXXX-------