------------------------------
------------------------------
------------------------------
------------------------------
------------------------------
------------------XX----------
-----------------XXX----------
----------------EXXX----------
-------X-------XXXXX--------X-
------XX------XXXXXX-------XX-
-----XXX-----XXXXXXX------XXX-
----XXXX----XXXXXXXX-----XXXX-
E--XXXXXE--XXXXXXXXX--X-XXXXX-
XXXXXXXXXXXXXXXXXXXXXXXXXXXXXX