------------------------------
------------------------------
-----------------oo-----------
---------------------E--E--E--
--------------------XXXXXXXXXX
-------------oo---------------
------------------------------
------------------------------
--------------XXXXXX----------
----------E-------------------
--------E<>-------------------
-------<>[]-------------------
-------[][]-------------------
X-X--XXXXXX-------------------