------------------------------
------------------------------
-------------oo---------------
-----------------E--E--E------
----------------XXXXXXXXXX----
---------oo-------------------
------------------------------
------------------------------
o-----E---XXXXXX--------------
-----<>-----------------------
-----[]-----------------------
-----[]-----------------------
-----[]-----------------------
--X--XX---------------------XX