-------------------------
-------------------------
-------------------------
-------------------------
-------------------------
-------------------------
-----------------oooooooo
-------------------------
-------------------------
-------------------------
--------E------X---------
-------<>------X---------
-------[]--EE--X---------
-XXX-XXXXXXXXXXXXXXXXXXXX