------------------------------
------------------------------
------------------------------
------------------------------
------------------------------
------------------------------
------------------------------
------------------------------
----E------E--------E-E-------
---------------E--------------
--------------<>--------------
--------------[]--------------
--------------[]-----------XX-
XX---XXXX---XXXXXX-----XX-----