------------------------------
------------------------------
------------------------------
--XX-----XX---------XXXX------
--XX-----XX---------XXXX------
--XX-----XX---------XXXX------
--XX-----XX---------XXXX------
--XX-----XX---------XXXX------
--XX-----XX---------XXXX------
--XX-----XX---------XXXX------
--XX-----XX---------XXXX------
--XX-----XX---------XXXX------
--XX-----XX---EE-E--XXXX------
XXXXXXXXXXXXXXXXXXXXXXXXXXXXXX