------------------------------
------------------------------
------------------------------
------------------------------
------------------------------
------------------------XX----
-XXX-------------------XXX----
----------------------XXXX----
---------------------XXXXX----
---------X----------XXXXXX---S
------X--X---------XXXXXXX----
------X--X----B---XXXXXXXX----
------X--X----b--XXXXXXXXX----
--XXXXX--X--XXXXXXXXXXXXXXXXXX