------------------------------
------------------------------
------------------------------
------------------------------
------------------------------
------------------------------
------------------------------
------------------------------
------------------------------
-----------------------------S
------------------------------
------------------------------
-E-E-E--E-E-E--E-E-E-E-E--E---
XXXXXXXXXXXXXXXXXXXXXXXXXXXXXX