------------------------------
------------------------------
------------------------------
------------------------------
------------------------------
--------------------XXXX--?---
-------------------XXXXX------
---------XX-------XXXXXX------
--------XXX------XXXXXXX------
--------XXX------XXXXXXX--Q---
--E---XXXXX----XXXXXXXXX------
-----XXXXXX---XXXXXXXXXX------
--------XXX------XXXXXXX------
-X-XXXXXXX--XXXXXXXXXXXXXXXXXX