------------------------------
------------------------------
------------------------------
--XX--XX---------XX--XX-------
--XX--XX---------XX--XX-------
--XX--XX---------XX--XX-------
--XX--XX---------XX--XX-------
--XX--XX---------XX--XX-------
--XX--XX---------XX--XX-------
--XX--XX---------XX--XX-------
--XX--XX---------XX--XX-------
--XX--XX---------XX--XX-------
--XX--XX--E-EE---XX--XX--E-EE-
XXXXXXXXXXXXXXXXXXXXXXXXXXXXXX