------------------------------
------------------------------
------------------------------
------------------------------
------------------------------
----SSSSSSS----SSSSSSS------SS
------------------------------
------------------------------
-S----------S-----------------
------------------------------
------------------------------
------------------------------
----------------------EE------
XXXXXXXXXXXXXXXXXXXXXXXXXXXXXX