---------------------------
---------------------------
---------------------------
---------------------------
---------------------------
-SSS-----------XXXX--?-----
--------------XXXXX--------
-------------XXXXXX--------
------------XXXXXXX--------
SSSSS-------XXXXXXX--Q-----
----------XXXXXXXXX------E-
---------XXXXXXXXXX--------
------------XXXXXXX-------X
XXXXXXXXXXXXXXXXXXXXXXXXXXX