--------------------------
--------------------------
--------------------------
--------------------------
--------------------------
SS-----------XX-----------
-------------XX-----------
-----------X-XX-----------
SS---------X-XX-----------
---------X-X-XX-----------
---------X-X-XX-----------
---------X-X-XX-----------
----X----X-X-XX----EE-E---
--XXXXX--X-X-XXXXXXXXXXXX-