------------------------------
------------------------------
------------------------------
------------------------------
------------------------------
---SSS--------SSSSSSSSSS------
------------------------------
-----------------------------<
-----------------------------[
-XX--------------------------X
-XX---------------------------
-XXX--------------------------
-XXX--------------------------
-XXXXXXXXXXXXXXX---------XXXXX