------------------------------
------------------------------
------------------------------
------------------------------
------------------------------
--S-------------------XXXX--?-
---------------------XXXXX----
----------X---------XXXXXX----
-E-EE-----X--------XXXXXXX----
-----XX-X-X-------XXXXXXXX--Q-
-----XX-X-X------XXXXXXXXX----
-----XX-X-X-----XXXXXXXXXX----
-----X--X-X----XXXXXXXXXXX----
-----X--X-X--XXXXXXXXXXXXXXXXX