------------------------------
------------------------------
--------------oo--------------
------------------E-----------
-----------------XXXX---------
----------oo---------------E--
------------------------------
-----------------------XX-----
-----------XXXXXX-------------
------XX---------------------X
-----XXX----------------------
----XXXX----------------------
---XXXXX------------------ooo-
-XXXXXXX------------------XXX-