------------------------------
------------------------------
------------------------------
------------------------------
------------------------------
--------------------------S-SQ
------------------------------
------------------------------
------------------------------
-----------------------------S
------------------------------
------------------------------
-E-E-E-E-E-E-E-E-E-E-E-E-E-E-E
XXXXXXXXXXXXXXXXXXXXXXXXXXXXXX