------------------------------
------------------------------
------------------------------
------------------------------
---o------o--------------o----
---------------SSSS-----------
------------------------------
-----------------------------X
----------------E-------------
--------------SSSSSS----------
------------------------------
------------------------------
------------------------------
X---X--X---X--XXXXXXX-X---X---