------------------------------
------------------------------
------------------------------
------------------------------
------------------------------
-----S------------------------
------------------------------
------------------------------
----E-EE----------------------
--------XX-X------------------
--------XX-X------------------
--------XX-X------------------
--------X--X---------E--------
--------X--X--XXXXXXXXXXXXXXXX