----------------------------
----------------------------
----------------------------
----------------------------
----------------------------
----------------------------
----------------------------
----------------------------
-------------------o--------
--------------oo------------
----------------------------
----------------------------
-EE----------------------XX-
XXXXXXXXXXXXXXXXXX---XX-----