-------------------------
-------------------------
-------------------------
-------------------------
------------E------------
-----------SQS-----------
-------------------------
-------------------------
-------------------------
-----------SQS-----SSQS--
-------------------------
---------X---------------
----EE---X---------------
--XXXXXXXXXXXXXXXXXXXXXXX