----------------------------
----------------------------
----------------------------
----------------------------
----------------------------
--S-------------------------
----------------------------
----------------------------
-E-EE----------------o------
-----XX-X--------XX---------
-----XX-XX------XXX---------
-----XX-XXX----XXXX---------
-----X--XXXX--XXXXX---------
-----X--XXXXXXXXXXX----XXXXX