------------------------------
------------------------------
------------------------------
------------------------------
------------------------------
-------SSS----------SSSSSSSSSS
------------------------------
------------------------------
---E--------------SS----------
-E<>--XXXXX--X----------------
<>[]--X------X----------------
[][]--X------X----------------
[][]--X------X----------------
XXXXXXXXX----X--XXXXX---------