------------------------------
------------------------------
------------------------------
------------------------------
------------------------------
-SS-----S-SS-----SSSS---------
------------------------------
------------------------------
------------------------------
------------------------------
------------------------------
------------------------------
---EE-------EE----------E-E--E
XXXXXXXXXXXXXXXXXXX---XXXXXXXX