------------------------------
------------------------------
------------------------------
------------------------------
------------------------------
--S------------SSSSSSSSS---SSS
------------------------------
------------------------------
-E-EE-------E-----------------
-----XX-X--<>-----------------
-----XX-X--[]-----------------
-----XX-X--[]-----------------
-----X--X--[]-----------------
-----X--X--XXXXXX--------XXXX-