------------------------------
------------------------------
------------------------------
------------------------------
------------------------------
------------------------------
------------------------------
------------------------------
---E----------E-------------E-
--<>---<-----<>---<--------<>-
--[]---[-----[]---[--------[]-
--[]---[-----[]---[--------[]-
--[]---[-----[]---[--------[]-
XXXXXXXXXXXXXXXXXXXXXXXXXXXXXX