------------------------------
------------------------------
------------------------------
------------------------------
------------------------------
--SS---SS------SSSS---SS--SS--
------------------------------
------------------------------
------------------------------
------------------------------
------------------------------
------------------------------
------------------------------
XX--XXX--X--XXX----XXX--XX--XX