------------------------------
------------------------------
------------------------------
------------------------------
------------------------------
-----S-----------S------S-----
------------------------------
------------------------------
----E-E----E----E-E----E-EE---
---------------------------XX-
---------------------------XX-
---------------------------XX-
---------------------------X--
XX-----XX---XX-----XX------X--