-------------------------
-------------------------
-------------------------
-------------------------
-------------------------
--------------SSSS-------
-------------------------
-------------------------
-------------------------
-<>--------X-------------
-[]-------XX-------------
-[]---<>-XXX------------X
-[]---[]XXXX-----------XX
XXXXXXXXXXXXXXXX---XXXXXX