------------------------------
------------------------------
------------------------------
------------------------------
---oo-------------------------
-------------SSSSSS---SSSSSSSS
------------------------------
------------------------------
------------------------------
----XXX-----------------------
------------------------------
------------------------------
------------------------------
X--------XXXXXX-----XXXX------