------------------------------
------------------------------
------------------------------
------------------------------
------------------------------
------------------------------
------------------------------
------------------------------
------------------------------
------------------------------
------------------------------
------------------------------
-EE-E-EE-E-EE-E-EE-E--E-E-E-EE
XXXXXXXXXXXXXXXXXXXXXXXXXXXXXX