-----------------------------
-----------------------------
-----------------------------
-----------------------------
---oo----oo------------------
-----------------------SSSSSS
-----------------------------
-----------------------------
------------------------E----
----XXXXX------XX-----SSSSSSS
-----------------------------
----------XXX----------------
-----------------------------
X------------------X--XXXXXXX