------------------------------
------------------------------
------------------------------
------------------------------
------------------------------
--------------------S---------
------------------------------
------------------------------
----E----E----E----E-EE-------
-----------------------XX-X---
-----------------------XX-X---
-----------------------XX-X---
-----------------------X--X---
XX---XX---XX---XX------X--X--X