------------------------------
------------------------------
------------------------------
------------------------------
------------------------------
--S----------------XXXX--?----
------------------XXXXX-------
-----------------XXXXXX-------
-E-EE-----------XXXXXXX-------
-----XX-X-------XXXXXXX--Q----
-----XX-X-----XXXXXXXXX------E
-----XX-X----XXXXXXXXXX-------
-----X--X-------XXXXXXX-------
-----X--X--XXXXXXXXXXXXXXXXXXX