------------------------------
------------------------------
------------------------------
------------------------------
------------------------------
--S---------S----------------S
------------------------------
------------------------------
-E-EE------E-EE-------------E-
-----XX-X------XX-X------X----
-----XX-X------XX-X------X----
-----XX-X------XX-X----X-X----
-----X--X------X--X----X-X----
-----X--X------X--X--X-X-X----