------------------------------
------------------------------
------------------------------
------------------------------
------------------------------
------------------------------
------------------------------
------------------------------
---E------E---E--------E-E----
--<>--<--<>--<>-------<><>----
--[]--[--[]--[]-------[][]----
--[]--[--[]--[]-------[][]----
E-[]E-[E-[]E-[]-------[][]----
XXXXXXXXXXXXXXXXXXXXXXXXXXXX--