--------------------------
--------------------------
--------------------------
--------------------------
--------------------------
----------------S---------
--------------------------
--------------------------
--------------------------
-----------Q--QQQQ-------X
------------------------XX
-----------------------XXX
---X------------------XXXX
XXXXXXXXXXXXXXXXXXXXXXXXXX