------------------------------
------------------------------
------------------------------
------------------------------
------------------------------
------------------------------
------------------------------
-------------------X----------
------------------XX----------
-----------------XXX----------
----------------XXXX----------
---X---X---X---XXXXX-------X--
--XX--XX--XX--XXXXXX------XX--
XXXXXXXXXXXXXXXXXXXXXXXXXXXXXX