------------------------------
------------------------------
------------------------------
------------------------------
------------------------------
----------XX--SSSSSSSSSSSSS---
---------XXX------------------
--------XXXX------------------
-------XXXXX------------------
------XXXXXX------------------
-----XXXXXXX------------------
----XXXXXXXX------------------
---XXXXXXXXX------------------
XXXXXXXXXXXXXXXX------------XX