-----------------------------
-----------------------------
----------?------------------
-----------------------------
-----------------------------
SSSS---------------XXX-------
------------SS----XXXX-------
-----------------XXXXX-------
SSSS----SS------XXXXXX-------
---------------XXXXXXX-------
--------------XXXXXXXX-------
-------------XXXXXXXXX-------
------------XXXXXXXXXX-------
----XXXXXXX-XXXXXXXXXXXXXXXXX