------------------------------
------------------------------
------------------------------
------------------------------
--------------------------o-oo
---SSS---SSSS---S-SSSS--------
------------------------------
------------------------------
------------------------------
S-----S----------------------X
------------------------------
------------------------------
------------------------------
XXXXX-XXXXX---XXXXXX---X------