------------------------------
------------------------------
------------------------------
-------X-------XX--------XX---
-------X-------XX--------XX---
-------X-------XX--------XX---
-------X-------XX--------XX---
-------X-------XX--------XX---
-------X-------XX--------XX---
-------X-------XX--------XX---
-------X-------XX--------XX---
-------X-------XX--------XX---
----E--X----E--XX---E-E--XX--E
XXXXXXXXXXXXXXXXXXXXXXXXXXXXXX