------------------------------
------------------------------
------------------------------
------------------------------
------------------------------
------E----SSSSSS--------S---S
------------------------------
--------X---------------------
------EXX---------------E-EEE-
-----<>XX------------X--------
-----[]XX------------X--------
----X[]XX------------X--------
---XX[]XX------------X--------
XXXXXXXXXXXXX-----X--X--------