-----------------------------
-----------------------------
-----------------------------
-----------------------------
------------------E----------
SSSS--------E-----E--E-------
--------------------XXXXX----
--------XX-------------------
SSSS-------------------------
--------------XXX------------
-----------------------------
-----------------------------
-----------ooo---------------
----XX-----XXX--------------X