------------------------------
------------------------------
------------------------------
--XX----XX--------------------
--XX----XX--------------------
--XX----XX--------------------
--XX----XX--------------------
--XX----XX--------------------
--XX----XX--------------------
--XX----XX---------------E-E-E
--XX----XX-----------X-XXXXXXX
--XX----XX--------------------
--XX----XX--------E-----------
XXXXXXXXXXXXXXXXXXXXX-X-------