------------------------------
------------------------------
----------------oo------------
--------------------E---------
------Eoo----------XXXX-------
------XXXX-------------------E
------------------------------
-------------------------XX---
--------------XXXXX-----------
----XXXXXXX-------------------
------------------------------
------------o-----------------
-----------XXX--------------oo
XXXX------------------------XX