------------------------------
------------------------------
------------------------------
------------------------------
----E---------E---------E-E---
--SSSSS-----SSSSS-----SSSSSSS-
------------------------------
------------------------------
------------------------------
------------------------------
------------------------------
------------------------------
------------------------------
XXXXXXXXXXXXXXXXXXXXXXXXXXXXXX