----------------------------
----------------------------
----------------------------
----------------------------
----------------------------
--------------------E-------
----------------------------
----------------------X-----
----S-S-------------EXX-----
------------X------<>XX-----
-----------XX------[]XX-----
----------XXX-----X[]XX-----
---------XXXX----XX[]XX--E--
XXXXXXXXXXXXXXXXXXXXXXXXXXXX