-------------------------
-------------------------
-------------------------
-------------------------
-------------------------
------E---XXX---------SSS
---------XXXX------------
--------XXXXX------------
------EXXXXXX--o---------
-----<>XXXXXX------------
-----[]XXXXXX----------E-
----X[]XXXXXX---------<>-
---XX[]XXXXXX---------[]-
XXXXXXXXXXXXXXXXXX-XXXXXX