-------------------------
-------------------------
-------------------------
-------------------------
-------------------------
------------SSSSS--------
-------------------------
-------------------------
-------------------------
-------------E----X------
------E-----------X------
------------------XX-----
E-E---------------XX-----
XXXXXXXXXXXXXXXXXXXXXXXXX