-------------------------
-------------------------
-------------------------
-------------------------
-------------------------
-------------------------
-------------------------
-------------------------
---------?---------------
-----------------ESS-----
-------------------------
-X-----------------------
-X-----------------------
XXXXXXXXXXXXXXXXXXXXXXXXX