------------------------------
------------------------------
------------------------------
------------------------------
------------------------------
--------------------XXXX------
-------------------XXXXX------
------------------XXXXXX------
-oo--------------XXXXXXX--?---
-------S---------XXXXXXX------
---------------XXXXXXXXX------
--------------XXXXXXXXXX------
-----------------XXXXXXX------
----XXXXXX--XXXXXXXXXXXXXXXXXX