------------------------
------------------------
------------------------
------------------------
----------E-------------
-----SSS--E--E----------
------------XXXXX-------
------------------------
------------------------
-E--XXXXX--------------<
<>--X------------------[
[]--X------------------[
[]--X------------------[
XXXXXXX-------------XXXX