-------------------------
-------------------------
-------------------------
-------------------------
-------------------------
-----------XXXX----------
----------XXXXX----------
---------XXXXXX----------
--------XXXXXXX----------
--------XXXXXXX---------X
------XXXXXXXXX--------XX
-----XXXXXXXXXX----<>-XXX
--------XXXXXXX----[]XXXX
XXXXXXXXXXXXXXXXXXXXXXXXX