------------------------------
------------------------------
------------------------------
------------------------------
------------------------------
--SQQS--SQQS----SQSQQS--------
------------------------------
------------------------------
------------------------------
---SS----SS------S-SS---------
------------------------------
------------------------------
-E-E---E-E-----E-E-E----E-E---
XXXXXXXXXXXXXXXXXXXXXXXXXXXXXX