-----------------------------
-----------------------------
-----------------------------
-----------------------------
-----------------------------
--------------SSSSSSSSSS-----
-----------------------------
-----------------------------
--------X--------------------
-------XX--------------------
------XXX--------------------
-----XXXX--------------------
----XXXXX------------------EE
XXXXXXXXXXXXXXXX---------XXXX