------------------------------
------------------------------
------------------------------
------------------------------
------------------------------
------------------------------
------------------------------
------------------------------
------------------------------
---X---------X----------------
---X---------X----------------
---X---------X----------------
---X---------X---------------X
X--XX--XX-X--XX--XX--XX----XXX