------------------------------
------------------------------
------------------------------
------------------------------
------------------------------
-----------------S------------
------------------------------
------------------------------
----------------E-EE----------
--------------------XX-X------
--------X--X--------XX-X------
--------X--X--------XX-X------
EE-E----X--X--------X--X--XXXX
XXXXX-XXX--XXX------X--X------