------------------------------
------------------------------
------------------------------
------------------------------
------------------------------
------------------------------
------------------------------
------------------------------
----------------------------E-
-----------SSS-------------<>-
---------------------------[]-
---------------------------[]-
----------------E-E-E-E-EE-[]E
XX--XXX--XXXXXXXXXXXXXXXXXXXXX