-------------------------
-------------------------
-------------------------
-------------------------
-------------------------
-------------SSSSSQSSSS?S
-------------------------
-------------------------
--------------E----------
-------------SSSSSSSSSSSS
----E----E---------------
---<>---<>---------------
---[]---[]---------------
XXXXXXXXXXXXXXXXXXXXXXXXX