----------------------------
----------------------------
----------------------------
----------------------------
----------------------------
----------------XXXX--?-----
---------------XXXXX--------
--------------XXXXXX--------
-------------XXXXXXX--------
-------X-----XXXXXXX--Q-----
-----XXX---XXXXXXXXX------E-
----XXXX--XXXXXXXXXX--------
---XXXXX-----XXXXXXX-------X
XXXXXXXXXXXXXXXXXXXXXXXXXXXX