------------------------------
------------------------------
------------------------------
------------------------------
------------------------------
----------------------SS--S---
------------------------------
------------------------------
---E---E----------------------
--<>--<>------E---------------
--[]--[]-----<>---------------
--[]--[]-----[]---------------
-E[]-E[]-----[]E--------------
XXXXXXXX---XXXXXXXXXXX--XX-XXX