------------------------------
------------------------------
------------------------------
------------------------------
----------oo------------------
-----------------E------SS--SS
----------------XXXX----------
------------------------------
----SS------------------------
-----------XXX---------------S
------------------------------
------------------------------
E-----------------------------
XXXXXXXX--------------XXXXXXXX