------------------------------
------------------------------
-------------oo---------------
-----------------E------------
----------------XXXX----------
---------oo------------E------
----------------------XXXX----
----------------------------XX
----------XXXXXX--------------
------------------------------
------------------------------
------------------------------
EE-EE-------------------------
XXXXXX------------------------