------------------------------
------------------------------
------------------------------
------------------------------
------------------------------
-----------------------------E
-------------E--E-------------
-----------XXXXXXXXXXXXXXXX---
------------------------------
-------XX---------------------
------------------------------
------------------------------
----------------------------oo
XXXXXXX---------------------XX