------------------------------
------------------------------
------------------------------
------------------------------
------------------------------
--S----------------SSSSSSSSS--
------------------------------
------------------------------
-E-EE-------------------------
-----XX-X----Q-QQ-------------
-----XX-X---------------------
-----XX-X---------------------
-----X--X---------------------
-----X--X--XXXXXXXXXX--------X