----------------------------
----------------------------
----------------------------
----------------------------
----------------------------
--S---------------SSSSSSS---
----------------------------
-----------------E----------
-E-EEE----------------------
------XXX-X----S?S----------
------XXX-X----------------E
------XXX-X-----------------
------X---X-----------------
------X---X--XXXXXXXXX----X-