------------------------------
------------------------------
------------------------------
------------------------------
------------------------------
------------------------------
------------------------------
------------------------------
------------------------------
-------------E----------------
------------<>----------------
------------[]----------------
-E---E------[]------EEEEEE-EEE
XXXXXXXXXX-XXXXXXXXXXXXXXXXXXX