------------------------------
------------------------------
------------------------------
------------------------------
---oo-------------------------
--------------E---XX-----E----
-----------------XXX----XXXX--
----------------XXXX----------
--------------EXXXXX----------
----XXX------<>XXXXX----------
-------------[]XXXXX----------
------------X[]XXXXX----------
-----------XX[]XXXXX----------
X--------XXXXXXXXXXXXX--------