----------------------------
----------------------------
----------------------------
----------------------------
----------------------------
----------------------------
----------------------------
----------------------------
----------------------------
-<>------X----X--------SS---
-[]-----XX----XX------------
-[]----XXX----XXX-----------
-[]---XXXX----XXXX----------
XXXXXXXXXXXXXXXXXXXXXXXXXXXX