------------------------------
------------------------------
------------------------------
------------------------------
------------------------------
----S---------------SSSSSSSSSS
------------------------------
------------------------------
---E-EE-----------SS----------
-------XX-X--X----------------
-------XX-X--X----------------
-------XX-X--X----------------
-------X--X--X----------------
X------X--X--X--XXXXX---------