------------------------------
------------------------------
------------------------------
------------------------------
------------------------------
--------------------------E---
------------------XXX----XXXX-
------------------------------
------------------------------
------------------------------
------------------------------
------------------------------
EE-E-----E--------------------
XXXXXXXXXXXXXXXX---XXXX-------