------------------------------
------------------------------
------------------------------
------------------------------
------------------------------
--S--------------SSSSSSSSSSS--
------------------------------
------------------------------
-E-EE---------E---------------
-----XX-X----<>---------------
-----XX-X----[]---------------
-----XX-X----[]---------------
-----X--X----[]---------------
-----X--X--XXXXXXXX----------X