-----------------------------
-----------------------------
-----------------------------
-----------------------------
-----------------------------
-----------------------XXX---
----------------------XXXX---
---------------------XXXXX---
-------------X------XXXXXX---
------------XX-----XXXXXXX---
-----------XXX----XXXXXXXX---
----------XXXX---XXXXXXXXX---
---------XXXXX--XXXXXXXXXX---
XXXXXXXXXXXXXXXXXXXXXXXXXXXXX