------------------------------
------------------------------
------------------------------
------------------------------
------------------------------
---SSS-----SSS----------------
------------------------------
------------------------------
---SSS-----SSS----------------
-------------------------S-S-S
------------------------------
------------------------------
E-----E-E-----E---------E-E---
XX----XXXX----XXXXXXXXXXXXXXXX