------------------------------
------------------------------
------------------------------
------------------------------
-------------------------o---o
--SS----SS----S-SS------------
------------------------------
------------------------------
------------------------------
------------------------------
------------------------------
------------------------------
------------------------------
XX--XXXX--XXXX-X--XXX-----X---