------------------------------
------------------------------
------------------------------
------------------------------
------------------------------
-------------SSSSSSSSSSS------
------------------------------
-----------------------------<
----------E------------------[
---------<>------------------X
--E------[]-------------------
------B--[]-------------------
------b--[]-------------------
-X-XXXXXXXXXXXX----------XXXXX