------------------------------
------------------------------
------------------------------
------------------------------
------------------------------
--------------oo-----E-----E--
--------------------XXXX--XXXX
------------------------------
---------------XXX------------
------------------------------
------------------------------
------------------------------
-E-E---E-EE-------------------
XXXXXXXXXXXX------------------