------------------------------
------------------------------
------------------------------
------------------------------
------------------------------
--SQ-----SQ------SQSQ---------
------------------------------
------------------------------
------------------------------
---S------S-------S-S---------
------------------------------
------------------------------
-E-E-E--E-E-E---E-E-E-E-------
XXXXXXXXXXXXXXXXXXXXXXXXX--X-X