------------------------------
------------------------------
------------------------------
------------------------------
------------------------------
----S----------S--------------
------------------------------
------------------------------
---E-EE-------E-EE-----------<
-------XX-XX------XX-X-------[
-------XX-XX------XX-X-------[
-------XX-XX------XX-X-------[
-------X--XX------X--X-------[
X------X--XX------X--X--XXX--X