-----------------------------
-----------------------------
-----------------------------
-----------------------------
-----------------------------
SSSSS------------XXXX--?-----
----------------XXXXX--------
---------------XXXXXX--------
SSSSS---------XXXXXXX--------
-------------XXXXXXXX--Q-----
------------XXXXXXXXX------E-
-----------XXXXXXXXXX--------
-------X--XXXXXXXXXXX-------X
-----XXXXXXXXXXXXXXXXXXXXXXXX