------------------------------
------------------------------
------------------------------
------------------------------
------------------------------
----------SS-------XXX--------
-------------------XXX--------
-----E-----------X-XXX--------
-o--<>--SS-------X-XXX-------X
----[]---------X-X-XXX------XX
----[]---------X-X-XXX-----XXX
----[]---------X-X-XXX----XXXX
----[]---------X-X-XXX---XXXXX
----XXXXXXX-X--X-X-XXXXXXXXXXX