------------------------------
------------------------------
------------------------------
------------------------------
----Eoo-----------------------
----XXXX---------------S------
----------------oo------------
------------------------------
------------XX--------E-EE----
-XXXXXXXX-----------------XX-X
--------------------------XX-X
----------o---------------XX-X
---------XXX--------------X--X
----------------XXXX------X--X