------------------------------
------------------------------
------------------------------
------------------------------
------------------------------
---SSSS-------SSSS--------SSSS
------------------------------
------------------------------
------------------------------
S------S-S-S------S-S---------
------------------------------
----------------------<>------
----------------------[]------
XXXXX--XXXXXXXXX--XXXXXXXXXX-X