----------------------------
----------------------------
----------------------------
----------------------------
----------------------------
-------XX------SSSSSSSS---SS
-------XX-------------------
-----XXXX-------------------
-----XXXX-------------------
-----XXXX---E---------------
----XXXXX--<>---------------
----XXXXX--[]---------------
----XXXXX--[]---------------
X-XXXXXXXXXXXXXXX-------XXXX