----------------------------
----------------------------
----------------------------
----------------------------
----------------------------
--S----------SSSSSSSSS------
----------------------------
---------------------------<
-E-EE----------------------[
-----XX-X--XX--------------X
-----XX-X--XX---------------
-----XX-X--XXX--------------
-----X--X--XXX--------------
-----X--X--XXXXX-------XXXXX