------------------------------
------------------------------
------------------------------
------------------------------
------------------------------
--------------------------E---
-------------------------XX---
------------------------------
------------------------------
--------------------E---------
-------------------<>---------
-------------------[]---------
-E----E--E----E----[]---------
XXXXXXXXXXXXXXXXXX-XX------X--