------------------------------
------------------------------
------------------------------
------------------------------
------------------------------
SSS----------SSSSSSSS---SSSS--
------------------------------
------------------------------
SSS-------------------------EE
-----oo-----------------------
------------------------------
------------------------------
------------------------------
---XXXXXX--XXXX-------XXXX----