------------------------------
------------------------------
--------------oo--------------
------------------E--E--E-----
----Eoo----------XXXXXXXXXX---
----XXXX----------------------
------------------------------
------------------------------
------------XXXXX-------------
-XXXXXXXX---------------------
------------------------------
----------o-------------------
---------XXX------------------
-----------------------------X