------------------------------
------------------------------
------------------------------
------------------------------
------------------------------
------------------------------
-----------------XXX----------
------------------------------
------------------------------
------------------------------
---X---X---X---XXX------X-X---
------------------------------
E---E---E---E--------------E--
XXX-XXX-XXX-XXX-------XX-X-XXX