------------------------------
------------------------------
------------------------------
------------------------------
------------------------------
-----SSSSSS------E----------SS
------------------------------
-------------------X----------
-----------------EXX------SS--
-SS-------------<>XX----------
----------------[]XX----------
---------------X[]XX----------
--------------XX[]XX----------
-XXXXXX-----XXXXXXXXXX--XXXXX-