------------------------------
------------------------------
------------------------------
-----------------------------X
-----------------------------X
-----------------------------X
-----------------------------X
-----------------------------X
-----------------------------X
-----------------------------X
-----------------------------X
-----------------------------X
EE--EEE--E------X----EEE-EE--X
XXXXXXXXXXXXXXXXXXXXXXXXXXXXXX