------------------------------
------------------------------
------------------------------
------------------------------
------------------------------
-----SS---------------SSSSSSSS
------------------------------
------------------------------
oo---SS-------------SS--------
-----------X------------------
-----------X------------------
-----------X------------------
-----------X------------------
---X---XX--X--XX--XXXXX-------