-----------------------------
-----------------------------
------------oo---------------
----------------E--E---------
---------------XXXXXXX-------
--------oo-------------------
-----------------------------
-----------------------------
---------XXXXXX--------------
-----------------------------
-----X---------------------XX
-----X--------------------XXX
-----X-----------------------
-XXXXX------------------XXXXX