------------------------------
------------------------------
------------------------------
------------------------------
------------------------------
------------------XXXX--?-----
-----------------XXXXX--------
----------------XXXXXX--------
-------o-------XXXXXXX--------
--E------------XXXXXXX--Q-----
-<>----------XXXXXXXXX------E-
-[]---------XXXXXXXXXX--------
-[]-E----------XXXXXXX-------X
XXXXXX----XXXXXXXXXXXXXXXXXXXX