------------------------------
------------------------------
------------------------------
------------------------------
------------------------------
--S-------------------SSSSSSSS
------------------------------
-----------------X------------
-E-EE-----------XX--SS--------
-----XX-X-------XX------------
-----XX-X-----XXXX------------
-----XX-X----XXXXX------------
-----X--X-------XX------------
-----X--X--XXXXXXXXXXXX-------