------------------------------
------------------------------
------------------------------
------------------------------
----------------oo------------
-----------------------E------
----------------------XXXX----
------------------------------
----SS------------------------
--------------XX--------------
-------<>---------------------
-------[]--------XXX----------
EE-----[]-EE------------------
XXXXXXXXXXXXXX--------------XX