------------------------------
------------------------------
------------------------------
------------------------------
------------------------------
--SS--S--SS--SSS--------------
------------------------------
------------------------------
------------------------------
---------------------------E-E
-------------------------XXXXX
------------------------------
------------------------------
XX--XX-XX--XX---X-XXXXXXX-----