------------------------------
------------------------------
------------------------------
------------------------------
------------------------------
-----SSS--------------?-------
--------------ooo-------------
-----------------------------X
------------E----------------X
-E--XXXXX--<>---------Q---XX-X
<>--X------[]-------------XX-X
[]--X------[]-------------XX-X
[]--X------[]-------------XX-X
XXXXXXX----XXXXXXXXXXXXXXXXX-X