------------------------------
------------------------------
------------------oo----------
----------------------E--E--E-
---------------------XXXXXXXXX
--------------oo--------------
------------------------------
------------------------------
---------------XXXXXX---------
-----------E------------------
----------<>------------------
----------[]------------------
----E-EE--[]------------------
--XXXXXXXXXX------------------