------------------------------
------------------------------
------------------------------
------------------------------
------------------------------
---------------SQSQ--------SQQ
------------------------------
------------------------------
------------------------------
----------------S-S---------SS
------------------------------
------------------------------
-E-E-E-E-E-EE-E-E-E-E-E-E-E-E-
XXXXXXXXXXXXXXXXXXXXXXXXXXXXXX