-------------------------
-------------------------
-------------------------
-------------------------
-------------------------
---------------XX--------
---------------XX--------
---------------XX--------
--E---------XX-XX--------
-<>--------XXX-XX--------
-[]-------XXXX-XX----E---
-[]------XXXXX-XX---<>--X
-[]-----XXXXXX-XX---[]--X
-XXXXXXXXXXXX--XXXXXXXXXX