-------------------------
-------------------------
-------------------------
-------------------------
-------------------------
--------SS---------------
-------------------------
-------------------------
-------------------------
-------------------------
------------------<>-----
------------------[]-----
----------EE------[]-EE-E
XXXXXXXXXXXXXXXXXXXXXXXXX