------------------------------
------------------------------
------------------------------
------------------------------
------------------------------
------------------------------
------------------------------
------------------------------
----------------oo------------
-----------------------------<
-----------------------------[
-----------------------------[
---XX------XX----------EEEE-E[
X-----X-X-----X-------XXXXXXXX