------------------------------
------------------------------
--------------oo--------------
------------------E-----------
----Eoo----------XXXX---------
----XXXX----------------------
------------------------------
------------------------------
------------XXXXX-------------
-XXXXXXXX---------------------
------------------------------
----------o-------------------
---------XXX--------------E-EE
-----------------------XXXXXXX