------------------------------
------------------------------
------------------------------
------------------------------
------------------------------
------------E--------E--------
-----------XXXXXXX--XXXXXXX---
------------------------------
------------------------------
------------------------------
------------------------------
------------------------------
-----------------------------X
XXXXXXXXX---------------------