------------------------------
------------------------------
------------------------------
------------------------------
------------------------------
-SSS-----SSSSSS-----S---------
------------------------------
------------------------------
-------SS---------------------
SSSSS-------------QQQQ-------X
----------------------------XX
---------------------------XXX
--------------------------XXXX
XXXXXXXXXX------XXXXXXXXXXXXXX