-----------------------------
-----------------------------
-----------------------------
-----------------------------
-----------------------------
----S------------------------
---------------E----E--------
-------------XXXXXXXXXXXXXXX-
---E-EE----------------------
-------XX-X------------------
-------XX-X------------------
-------XX-X------------------
-------X--X------------------
-------X--X------------------