------------------------------
------------------------------
------------------oo----------
----------------------E--E--E-
--------oo-----------XXXXXXXXX
--------------oo--------------
------------------------------
----X-------------------------
----X----------XXXXXX---------
--X-X----XXX------------------
--X-X-------------------------
--X-X-------------------------
--X-X-------------------------
--X-X-------------------------