------------------------------
------------------------------
------------------------------
------------------------------
------------------------------
------------S---------E-----E-
---------------------XXXX--XXX
------------------------------
-----------E-EE---------------
---------------XX-X-----------
---------------XX-X-----------
---------------XX-X-----------
E-E--XX--------X--X-----------
XXXXXXXXX------X--X-----------