------------------------------
------------------------------
------------------------------
------------------------------
------------------------------
------------------------------
-----------E------------E---E-
--------XXXXX--------XXXXXXXXX
------------------------------
------------------------------
--XX--XXX------XX--XXX--------
------------------------------
------------------------------
X---X--------X---X------------