-----------------------------
-----------------------------
-----------------------------
-----------------------------
-----------------------------
--S-------------SSSSSSSSSSSSS
-----------------------------
-----------------------------
-E-EE------o-----------------
-----XX-X--------------------
-----XX-X--------E-----------
-----XX-X-------<>-----------
-----X--X-------[]-----------
-----X--X-----XXXXXXXXXXXX---