------------------------------
------------------------------
------------------------------
------------------------------
------------------------------
---SS-----SS-------------SS--S
------------------------------
------------------------------
---SS-----SS-------?-----SS---
------------------------------
------------------------------
------------------------------
E----E-E----E-----------------
XX---XXXX---XXXXXXXXXX-X---XXX