-------------------------
-------------------------
-------------------------
-------------------------
-------------------------
-------------XX---SSSSS--
------------XXX----------
-----------XXXX----------
----------XXXXX----------
---------XXXXXX----------
--------XXXXXXX----------
----<>-XXXXXXXX----------
----[]XXXXXXXXX--------EE
XXXXXXXXXXXXXXXXXXXXXXXXX