-------------------------
-------------------------
-------------------------
-------------------------
-------------------------
-------------------------
-------------------------
-------------------------
-------------------------
---------XX--------------
---------XX-----------E--
---------XX--------------
---------XX--------------
XXXXXXX--XX--XXX-----X-XX