------------------------------
------------------------------
--------?------------oo-------
-------------------------E--E-
------------------------XXXXXX
-----------------oo-----------
----------SS------------------
------------------------------
------SS----------XXXXXX------
-------------XX---------------
------------XXX---------------
-----------XXXX---------------
----------XXXXX---------------
----XXXXX-XXXXX---------------