------------------------------
------------------------------
------------------------------
------------------------------
------------------------------
-----------------------SSSSSS-
------------------------------
------------------------------
--E-------E-----E-------------
-<>----<-<>----<>------------S
-[]----[-[]----[]-------------
-[]----[-[]----[]-------------
-[]----[-[]----[]-------------
XXXXXXXXXXXXXXXXX--XXXXXX----X