------------------------------
------------------------------
------------------------------
------------------------------
------------------------------
-----------XXX---------XX-----
----------XXXX--------XXX-----
---------XXXXX-------EXXX-----
--------XXXXXX------XXXXX-----
-------XXXXXXX-----XXXXXX-----
------XXXXXXXX----XXXXXXX-----
--<>-XXXXXXXXX---XXXXXXXX-----
--[]XXXXXXXXXX--XXXXXXXXX--E--
XXXXXXXXXXXXXXXXXXXXXXXXXXXXXX