------------------------------
------------------------------
------------------------------
------------------------------
------------------------------
---------------SSSSSSSSSSS----
------------------------------
------------------------------
-----S------------------------
----------X-------------------
----------X-------------------
----------X-------------------
----------X-------------------
-XXXXXXX--X--XXXX----------XXX