------------------------------
------------------------------
------------------------------
------------------------------
------------------------------
-------------E--------------SS
------------XXXXXXXXX---------
------X-----------------------
-----XX-----------------------
-----XX-----------------------
---XXXX-----------------------
--XXXXX-----------------------
-----XX-----------------EE----
XXXXXXXXXX-------------XXXXXXX