------------------------------
------------------------------
------------------------------
------------------------------
-----------------E------------
-----S-----------E--E---------
-------------------XXXX----E--
-------------------------XXXXX
----E-EE----------------------
--------XX-X--XX--------------
--------XX-X------------------
--------XX-X------------------
--------X--X------------------
--------X--X------------------