-----------------------------
-----------------------------
-----------------------------
-----------------------------
-----------------------------
------SSS------SSSSSSSS---SS-
-----------------------------
-----------------------------
----SS-----------------------
-----------------------------
-----------------------------
-----------------------------
E---------------------------E
XXXXXXX---XX-XXXX-------XXXXX