------------------------------
------------------------------
------------------------------
------------------------------
------------------------------
--------------XX-------------S
-------------XXX--------------
------------EXXX---------X----
-----------XXXXX--------XX---S
----------XXXXXX-------XXX----
---------XXXXXXX------XXXX----
--------XXXXXXXX-----XXXXX----
E--XE--XXXXXXXXX--X-XXXXXX----
XXXXXXXXXXXXXXXXXXXXXXXXXXXX--