--------------------------
--------------------------
--------------------------
--------------------------
--------------------------
--S----------SSSSSSSSSSS--
--------------------------
--------------------------
-E-EE---------------------
-----XX-X-----------------
-----XX-X-----------------
-----XX-X-----------------
-----X--X-----------------
-----X--X--XXXXXXXX------X