-------------------------
-------------------------
-------------------------
-------------------------
-------------------------
---------SSQ-------------
-------------------------
-------------------------
-------------------------
--XSS------S-------------
--X----------------------
--X----------------------
-EX---------E-E----------
XXXXXXXXXXXXXXXXXXX-XXXXX