-------------------------
-------------------------
-------------------------
-------------------------
-------------------------
----SSSQ-----------------
-------------------------
-------------------------
-------------------------
--XX---S-------------SSQS
--XX---------------------
--XXX--------------------
--XXX---E--XXXX----------
--XXXXXXXXXXXXXXXXXXXXXXX