------------------------------
------------------------------
------------------------------
------------------------------
------------------------------
-------S---------------SSSSSSS
------------------------------
-----------------oo-----------
------E-EE-----------SS-------
--XX------XX-XXX--------------
--XX------XX-XXX--------------
X-XX------XX-XXX--------------
X-XX------X--XXX--------------
X-XX------X--XX---XXXXXX------