------------------------------
------------------------------
------------------------------
------------------------------
------------------------------
---SS---SS---SS---SS------SSSS
------------------------------
------------------------------
---SS---SS---SS---SS------SSSS
------------------------------
------------------------------
------------------------------
E----E----E----E--------------
XX---XX---XX---XX---XXXXX-----