------------------------------
------------------------------
------------------------------
------------------------------
------------------------------
------------------------------
------------------------------
------------------------------
------------------------------
---X-----X------------X---X---
---X-----X------------X---X---
---X-----X------------X---X---
---X-----X------------X---X---
X--XX-X--XX--XX----X--XX--XX--