------------------------------
------------------------------
------------------------------
------------------------------
----------------------------o-
--SS----SS--------------------
------------------------------
------------------------------
------------------X-----------
-----------------XX-----------
----------------XXX-----------
---------------XXXX-----------
--------------XXXXX-----------
XX--XXXX--XXXXXXXXXXXXXX-----X