------------------------------
------------------------------
------------------------oo----
----------------------------E-
---------------------------XXX
---------------SS---oo--------
------------------------------
------------------------------
o--------------------XXXXXX---
--------------XXXX------------
-----------XXXXX--------------
--------XXXXXX----------------
-------XXXXX------------------
--XXXXXXXX------XX------------