------------------------------
------------------------------
------------------------------
------------------------------
------------------------------
------------------XXXX--?-----
----E------------XXXXX--------
---<>-----------XXXXXX--------
---[]----------XXXXXXX--------
---XX----------XXXXXXX--Q-----
-------------XXXXXXXXX------E-
------B-----XXXXXXXXXX--------
------b--------XXXXXXX-------X
--XXXXXXXXXXXXXXXXXXXXXXXXXXXX