------------------------------
------------------------------
------------------------------
------------------------------
---oo-------------------------
------------------------------
------------------------------
------------------------------
------------------------------
----XXX------S----------------
------------------------------
------------------------------
------------------XXXX--XXX--X
X--------XXXXXXX--------------