------------------------------
------------------------------
------------------------------
------------------------------
------------------------------
--S---------S-----------------
------------------------------
------------------------------
-E-EE------E-EE---------------
-----XX-X------XX-X-----------
-----XX-X------XX-X-----------
-----XX-X------XX-X-----------
-----X--X------X--X----E-E----
-----X--X------X--X--XXXXXXX--