------------------------------
------------------------------
------------------------------
------------------------------
----Eoo------------E----------
----XXXX-----------E--E-------
---------------------XXXX-----
---------------------------XX-
------------XX----------------
-XXXXXXXX-------XX------------
------------------------------
----------o-------------------
---------XXX------------------
------------------------------