------------------------------
------------------------------
------------------------------
------------------------------
------------------------------
--SQ----SQ-----SQQQQS--SQ--SQQ
------------------------------
------------------------------
------------------------------
---S-----S------SSSS----S---SS
------------------------------
------------------------------
-E-E-E-E-E-EE-E-E-E---E-E-E-E-
XXXXXXXXXXXXXXXXXXXXXXXXXXXXXX