------------------------------
------------------------------
------------------------------
------------------------------
------------------------------
SS---------XX-----S---------S-
----------XXX-----------------
---------XXXX-----------------
SS------XXXXX----E-EE------E-E
--------XXXXX--------XX-X-----
------XXXXXXX--------XX-X-----
-----XXXXXXXX--------XX-X-----
--------XXXXX--------X--X-----
--XXXXXXXXXXXXX------X--X-----