----------------------------
----------------------------
----------------------------
----------------------------
----------------------------
SS---------------XXXX-------
----------------XXXXX-------
---------------XXXXXX-------
SS------------XXXXXXX-------
--------------XXXXXXX-------
------------XXXXXXXXX-------
-----------XXXXXXXXXX----<>-
--------------XXXXXXX----[]X
--XXXXX--XXXXXXXXXXXXXXXXXXX