-------------------------
-------------------------
-------------------------
-------------------------
-------------------------
--------------QQQQ---QQQQ
-------------------------
-------------------------
-------------------------
----<>------QQ?SSQQQQ?SSQ
----[]-------------------
----[]-------------------
--E-[]-------------------
-XXXXXXXXXXXXXX--XXXXX--X