------------------------------
------------------------------
------------------------------
------------------E-----------
----------------XXXXX---------
------------------------------
--------------E---------------
----------XXXXXX--------------
------------------------------
------------------------------
---XX---XXX------------XXXXX--
------------------------------
E----E----------------------E-
XXX--XXX--------------------XX