------------------------------
------------------------------
------------------------------
------------------------------
------------------------------
------SSSS--------XX----------
------------------XX----------
----------------XXXX----------
----SS----------XXXX----------
----------------XXXX----------
---------------XXXXX---<>-----
---------------XXXXX---[]-----
E-----------E--XXXXX---[]-E---
XXXXXXX----XXXXXXXXXXXXXXXXXXX