------------------------------
------------------------------
------------------------------
------------------------------
------------------------------
------------------------------
------------------------------
------------------------------
------------------------------
------------XSS---------------
------------X-----------------
------------X-----------------
-----------EX------------E-E--
XX--XXX--XXXXXXX----XX--XXXXX-