------------------------------
------------------------------
------------------------------
------------------------------
------------------------------
---------------SSSSSSSSS------
------------------------------
-----------------------------<
-----------------------------[
-----------------------------X
------------------------------
------------------------------
--------X---------------------
XXXXXXXXXXX--XXXX--------XXXXX