------------------------------
------------------------------
------------------------------
------------------------------
---------------------------XX-
------------------------------
-------------------------E----
----------X----------XXXXXX---
------------------------------
------------------------------
---X---XXXX---X---XXXX--------
------------------------------
E---E------E---E--------------
XXX-XXX----XXX-XXX------------