------------------------------
------------------------------
------------------------------
------------------------------
------------------------------
------------------SSSSSSSSSS--
------------------------------
---------X-----o--------------
--------XX--------------------
-------XXX---SS---------------
------XXXX--------------------
--<>-XXXXX--------------------
--[]XXXXXX--------------------
XXXXXXXXXXXX-XXXXXXX---------X