------------------------------
------------------------------
------------------------------
------------------------------
--------------oo-----E--------
--S------------------E--E-----
-----------------------XXXXXX-
------------------------------
-E-EE-------------------------
-----XX-X--X---XXXXX----------
-----XX-X--X------------------
-----XX-X--X------------------
-----X--X--X------------------
-----X--X--X------------------