------------------------------
------------------------------
------------------------------
------------------------------
------------------------------
----------------SSSSSSSSS-----
------------------------------
------------oo----------------
------------------------------
-----S--XXX-------------------
--------XXX-------------------
--------XXX-------------------
--------XXX-------------------
XXXXXXXXXX---XXXXX--------XXXX