-------------------------
-------------------------
-------------------------
-------------------------
-------------------------
-----------------------SS
-------------------------
-------------------------
----------E---------SSS--
---------<>---E----------
--E------[]--<>---E------
------B--[]--[]--<>------
------b--[]--[]--[]------
-X-XXXXXXXXXXXXXXXXXXXXX-