------------------------------
------------------------------
------------------------------
------------------------------
------------------------------
------------------------------
------------------------------
-----XX-------XX---------XXXX-
-----XX-------XX---------XXXX-
S----XX-SS----XX-SS------XXXX-
----XXX------XXX-----E--XXXXX-
----XXX------XXX----<>--XXXXX-
----XXX------XXX----[]--XXXXX-
XXXXXXX-XXXXXXXX-XXXXXXXXXXXX-