-----------------------
-----------------------
-----------------------
-----------------------
-----------------------
-----------------XX----
----------------XXX----
---------------EXXX----
--------------XXXXX----
-------------XXXXXX----
------------XXXXXXX----
-----------XXXXXXXX----
----------XXXXXXXXX----
XXXXXX-XXXXXXXXXXXXXXXX