------------------------------
------------------------------
------------------------------
------------------------------
------------------------------
---SSS-----SSS----------SSSS--
------------------------------
------------------------------
---SSS-----SSS------E---SSSS--
-------------------<>---------
-------------------[]---------
-------------------[]---------
E-----E-E-----E----[]-------E-
XX----XXXX----XXXXXXXXX-----XX