----------------------------
----------------------------
----------------------------
----------------------------
----------------------------
SSS-------------XXXX--?-----
---------------XXXXX--------
--------------XXXXXX--------
SSS----------XXXXXXX--------
-------------XXXXXXX--Q-----
-----------XXXXXXXXX------E-
----------XXXXXXXXXX--------
-------------XXXXXXX-------X
---XXXXXXXXXXXXXXXXXXXXXXXXX