------------------------------
------------------------------
------------------------------
------------------------------
------------------------------
--S----------SS-----S---------
------------------------------
----------------------------X-
-E-EE--------------E-EE-----X-
-----XX-X--------------XX-X-X-
-----XX-X--------------XX-X-X-
-----XX-X--------------XX-X-X-
-----X--X--------------X--X-X-
-----X--X--XXXXXX------X--X-X-