------------------------------
------------------------------
------------------------------
------------------------------
------------------------------
---SSS------SSS---------SSSSS-
------------------------------
------------------------------
---SSS------SSS---------SSSSS-
--------------------SS--------
------------------------------
------------------------------
E-----E--E-----E-------------E
XX----XX-XX----XX---XXX------X