------------------------------
------------------------------
------------------------------
------------------------------
------------------------------
---SSSS---SSSS----S-SSSS------
------------------------------
------------------------------
------------------------------
S------S----------------S-----
------------------------------
------------------------------
------------------------------
XXXXX--XXXXX---XXXXXXX--XX-X--