------------------------------
------------------------------
------------------------------
------------------------------
------------------------------
SS------SSSSSSS-----S---------
------------------------------
------------------------------
SS----------------------------
------------------QQQQ-------X
----------------------------XX
---------------------------XXX
----X---------------------XXXX
--XXXXXXXX------XXXXXXXXXXXXXX