------------------------------
------------------------------
------------------------------
------------------------------
------------------------------
-----------------------SSQ----
------------------------------
------------------------------
------------------------------
---X----------X----------S----
---X----------X---------------
---X----------X---------------
---X----------X-----------E--X
X--XX--X--XX--XX--X--XXXXXXXXX