-----------------------------
-----------------------------
-----------------------------
-----------------------------
-----------------------------
-----------------------------
-----------------------------
-----------------------------
--------o------------------o-
-----------------------------
-----------------------E-----
----------------------<>-----
----------------XX----[]-----
XXXXXXX---XXXX------XXXXXX---