------------------------------
------------------------------
------------------------------
------------------------------
------------------------------
---S---SS---S---SSSSSS-----S-S
------------------------------
------------------------------
--------------------------E-E-
S---S----S---S----S-----------
--------------------E---------
------------------------------
------------------------------
XXXXXXXXXXXXXXXXXXXXXXXX------