------------------------------
------------------------------
------------------------------
------------------------------
------------------------------
------E-------S---------S--S--
------------------------------
--------X---------------------
------EXX----E-EEEE----E-EE-EE
-----<>XX----------XX---------
-----[]XX----------XX---------
----X[]XX----------XX---------
---XX[]XX----------X----------
XXXXXXXXXXX--------X----------