------------------------------
------------------------------
------------------------------
------------------------------
------------------------------
---SSSSS---SSSSS---SS--SSSSSSS
------------------------------
------------------------------
-------------------SS---------
S-------S---------------------
------------------------------
------------------------------
------------------------------
XXXXX---XXXXX----X---XXXX-X---