------------------------------
------------------------------
------------------------------
------------------------------
------------------------------
-----------------SSSS---------
------------------------------
------------------------------
------------------------------
---X------X---------------X-X-
---X------X---------------X-XX
---X------X---------------X-XX
---X------X---------------X-XX
X--XX--X--XX--XXXXX---XX--X-XX