---------------------------
---------------------------
---------------------------
---------------------------
---------------------------
-----------SSSSSSSSSS------
---------------------------
---------------------------
---------------------------
---------------------------
---------------------------
---------------------------
-EE---------------------EE-
XXXX--XXXXXXX---------XXXXX