------------------------------
------------------------------
------------------------------
------------------------------
------------------------------
--S---------------SSSSSSSSS---
------------------------------
------------------------------
-E-EE-------------------------
-----XX-X---------------------
-----XX-X---------------------
-----XX-X---------------------
-----X--X---E-----------------
-----X--X--XXXX-XXXX--------XX