------------------------------
------------------------------
------------------------------
------------------------------
------------------------------
------------------------------
------------------------------
------------------------------
------------------------------
---------EE---------EE-EE-----
--XX--XXXXX--XX--XXXXXXXXXXXX-
------------------------------
------------------------------
X---X------X---X-------------X