------------------------------
------------------------------
------------------------------
------------------------------
------------------------------
--------------XXX-------SSSSSS
-------------XXXX---E---------
------------XXXXX--<>---------
-----------XXXXXX--[]---------
-----------XXXXXX--XXX--------
---------XXXXXXXX-------------
--------XXXXXXXXX-------------
---X-------XXXXXX-------------
XXXXXXXXXXXXXXXXXXXXXXXXXX----