------------------------------
------------------------------
------------------------------
------------------------------
------------------------------
------------------------------
------------------------------
------------------------------
------------------------------
-------------------Q----------
------------------------------
------------------------------
-EE-E-EE--EE-E-EE-----EEEE-E-E
XXXXXXXXXXXXXXXXXXXXXXXXXXXXXX