----------------------------
----------------------------
----------------------------
----------------------------
----------------------------
--S----------------SSSSSSSSS
----------------------------
---------------oo-----------
-E-EE-----------------------
-----XX-X--XXX--------------
-----XX-X--XXX--------------
-----XX-X--XXX--------------
-----X--X--XXX--------------
-----X--X--XX---XXXXX-------