-------------------------
-------------------------
-------------------------
-------------------------
-------------------------
------------S------------
-------------------------
-------------------------
-------------------------
------------S------------
------------------------X
-----------------------XX
--------X-------------XXX
XXXXXXXXXXXXXXXXXXXXXXXXX