------------------------------
------------------------------
------------------------------
------------------------------
------------------------------
--------------------SQQS------
------------------------------
------------------------------
------------------------------
---------------------SS-------
------------------------------
------------------------------
-EE-E-EE-E-EE-E-EE-E-E--------
XXXXXXXXXXXXXXXXXXXXXXXXXX----