------------------------------
------------------------------
------------------------------
------------------------------
------------------------------
-----------------SSSSSSSSSSS--
------------------------------
---------X--------------------
--------XX--------------------
-------XXX--------------------
-----XXXXX--------------------
----XXXXXX--------------------
---XXXXXXX--EEE---------------
XXXXXXXXXXXXXXXXXXX----------X