-----------------------------
-----------------------------
-----------------------------
-----------------------------
-----------------------------
--------S--------------------
-----------------------------
---X-------------------------
---X---E-EE------------------
-X-X-------XX-X--------------
-X-X-------XX-X-----------E--
-X-X-------XX-X--------------
-X-X-------X--X--------------
-X-X-------X--X--XXX-----X-XX