------------------------------
------------------------------
------------------------------
------------------------------
------------------------------
---SSSS---SSSSSSSSSS---S-SSSS-
------------------------------
------------------------------
------------------------------
S------S---------------------S
------------------------------
------------------------------
------------------------------
XXXXX--XXXXX---------XXXXXX--X