------------------------------
------------------------------
------------------------------
------------------------------
------------------------------
--S---------------SSSSSSSSSSS-
------------------------------
------------------------------
-E-EE-------------------------
-----XX-X---------------------
-----XX-X---------------------
-----XX-X---------------------
-----X--X---E-EE--------------
-----X--X--XXXXXXXXX----------