------------------------------
------------------------------
------------------------------
------------------------------
------------------------------
-----SS------SSSSSSSSSSS------
------------------------------
-----------------------------<
-----SS----------------------[
----------E------------------X
---------<>-------------------
---------[]-------------------
---------[]-------------------
XXXX---XXXXXXXX----------XXXXX