------------------------------
------------------------------
------------------------------
------------------------------
------------------------------
-----SS------------XXXX--?----
------------------XXXXX-------
-----------------XXXXXX-------
-----SS---------XXXXXXX-------
----------E-----XXXXXXX--Q----
---------<>---XXXXXXXXX------E
---------[]--XXXXXXXXXX-------
---------[]-----XXXXXXX-------
XXXX---XXXXXXXXXXXXXXXXXXXXXXX