------------------------------
------------------------------
------------------------------
------------------------------
------------------------------
---------------oo-----E-------
---------------------XXXX----E
---------------------------XXX
--------oo--------------------
-------------XX--XX-----------
------------------------------
------------------------------
EE-E-E------------------------
XXXXXXX----XX-----------------