------------------------------
------------------------------
------------------------------
------------------------------
------------------------------
--SS-----SS------------SS-----
------------------------------
------------------------------
------------------------------
---------------ESS------------
------------------------------
------------------------------
------------------------------
XX--XXXXX--XXXXXXXXXXXX--XXXXX