------------------------------
------------------------------
------------------------------
------------------------------
------------------------------
------------------------------
------------------------------
------------------------------
-E------E-------E-E-----------
<>-----<>------<>->-----------
[]-----[]------[]-]-----------
[]-----[]------[]-]-----------
[]----E[]----E-[]-]----E---X-X
XXXXXXXXXXXXXXXXXXXXXXXXX-----