-------------------------
-------------------------
-------------------------
-------------------------
-------------------------
------XX-------------SSS-
------XX-----------------
----X-XX-----------------
----X-XX-----------------
--X-X-XX------------XXXXX
--X-X-XX--------E---X----
X-X-X-XX-------<>---X----
X-X-X-XX-------[]---X----
X-X-X-XXXX-XXXXXXXXXXXX--