-----------------------------
-----------------------------
-----------------------------
-----------------------------
-----------------------E-----
-----------S-----------E--E--
-------------------------XXXX
-----------------------------
-oo-------E-EE---------------
------XX------XX-X--XX-------
--------------XX-X-----------
--------------XX-X-----------
--------------X--X-----------
----XX--------X--X-----------