------------------------------
------------------------------
------------------------------
------------------------------
------------------------------
-------E------------------E---
------XXXX---------------XXXXX
----------------oo------------
------------------------------
------------XXX---------------
------------XXX---------------
------------XXX---------------
E-E---------XXX-----X---------
XXXX--------XX---XXXXXX-------