------------------------------
------------------------------
------------------------------
------------------------------
------------------------------
---------------------SSSSS----
------------------------------
------------------------------
---E---E----E-E------SSSSS----
--<>--<>---<>->---------------
--[]--[]---[]-]---------------
--[]--[]---[]-]---------------
E-[]E-[]---[]-]-E-E-----------
XXXXXXXXXXXXXXXXXXXX------XXXX