------------------------------
------------------------------
------------------------------
------------------------------
------------------------------
----SSSSS---------XXXX--------
-----------------XXXXX--------
----------------XXXXXX--------
---------------XXXXXXX--------
-E-X-----------XXXXXXX--------
<>-X---------XXXXXXXXX--------
[]-X--------XXXXXXXXXX----<>-X
[]-X-----------XXXXXXX----[]XX
XXXXXXX---XXXXXXXXXXXXXXXXXXXX