------------------------------
------------------------------
------------------------------
------------------------------
------------------------------
-----------------------SSSSSSS
------------------------------
------------------------------
------------------------------
------------------------------
------------------------------
------------------------------
-E-E-E-E--E-E-E-E-E-E---------
XXXXXXXXXXXXXXXXXXXXXXXXX-----