------------------------------
------------------------------
------------------------------
------------------------------
------------------------------
----------------------------SS
------------------------------
------------------------------
----------------------------SS
S---S---S---S-----------------
----------------E-------------
------------------------------
---------------------E-E-E----
XXXXXXXXXXXXXXXXXXXXXXXXXXX---