------------------------------
------------------------------
------------------------------
------------------------------
------------------------------
--SQ----SQ-----SQSQ-------SQ--
------------------------------
------------------------------
------------------------------
---S-----S------S-S--------S--
------------------------------
------------------------------
-E-E-E-E-E-EE-E-E-E-EE-E-E-E-E
XXXXXXXXXXXXXXXXXXXXXXXXXXXXXX