------------------------------
------------------------------
------------------------------
------------------------------
------------------------------
SSS---------XX---------XX-----
-----------XXX--------XXX-----
----------XXXX-------XXXX-----
SSS------XXXXX------XXXXX-----
---------XXXXX-----XXXXXX-----
-------XXXXXXX----XXXXXXX-----
------XXXXXXXX---XXXXXXXX-----
---------XXXXX--XXXXXXXXX-----
---XXXXXXXXXXXXXXXXXXXXXXXXXXX