------------------------------
------------------------------
------------------------------
------------------------------
------------------------------
---SSS-----SSS-------SSSSSSSSS
------------------------------
------------------------------
------------------------------
-XX-----XXX-------------------
-XX-----XXX-------------------
-XXX----XXXX------------------
-XXX----XXXX-----XX-----------
-XXXXXXXXXXXXXXXXXXXXXX-------