------------------------------
------------------------------
------------------------------
------------------------------
------------------------------
-----S------S---------S-------
------------------------------
------------------------------
----E-E----E-EE------E-EEEE---
---------------XX-X--------XX-
---------------XX-X--------XX-
---------------XX-X--------XX-
---------------X--X--------X--
XX-----XX------X--X--------X--