------------------------------
------------------------------
------------------------------
------------------------------
--------------------------o-o-
--SS--SS---SS--SS-------------
------------------------------
------------------------------
------------------------------
------------------------------
------------------------------
-------------------E----------
------------------------------
XX--XX--XXX--XX--X-X-XXX-----X