------------------------------
------------------------------
------------------------------
---------------------------XX-
---------------------------XX-
--SS----SS---SS----SS------XX-
---------------------------XX-
---------------------------XX-
---------------------------XX-
---------------------------XX-
---------------------------XX-
---------------------------XX-
---------------------------XX-
XX--XXXX--XXX--XXXX--XXXXXXXXX