------------------------------
------------------------------
------------------------------
------------------------------
------------------------------
---SSSSS---SSSSSSSSS---SSSSSSS
------------------------------
------------------------------
------------------------------
S-------S---------------------
------------------------------
------------------------------
------------------------------
XXXXX---XXXXX--------XXXXXX---