------------------------------
------------------------------
------------------------------
------------------------------
------------------------------
--S------------------SSSSSSSSS
------------------------------
------------------X-----------
-E-EE------------XX-----------
-----XXX-X-------XX-----------
-----XXX-X-----XXXX-----------
-----XXX-X----XXXXX-----------
-----X---X-------XX-----------
-----X---X--XXXXXXXXXXX-------