------------------------------
------------------------------
------------------------------
------------------------------
------------------------------
--SQ------SQ-----------------S
------------------------------
------------------------------
------------------------------
---S-------S------------------
------------------------------
------------------------------
-E-E-E-E-E-E-E-E---EEEEEE-E-E-
XXXXXXXXXXXXXXXXXXXXXXXXXXXXXX