------------------------------
------------------------------
------------------------------
------------------------------
------------------------------
---SSSS-----SSSS---------SSSSS
------------------------------
------------------------------
------------------------------
S------S-S------S---ooo-------
------------------------------
------------------------------
------------------------------
XXXXX--XXXXXXX--XXXXXXXXXXX---