------------------------------
------------------------------
------------------------------
------------------------------
------------------------------
------------SS----------------
------------------------------
------------------------------
------------------------------
------------------------------
------------------------------
------------------------------
-EE-E-EE-E----EE-E-E-EE-E-EE-E
XXXXXXXXXXXXXXXXXXXXXXXXXXXXXX