------------------------------
------------------------------
------------------------------
------------------------------
------------------------------
SS-----------S----------SSSSSS
------------------------------
------------------------------
SS----------E-EE--------------
---------X------XX-X----------
---------X------XX-X----------
---------X------XX-X----------
----X----X------X--X----------
--XXXXX--X------X--X--XXXX----