------------------------------
------------------------------
------------------------------
------------------------------
------------------------------
---SSSS---SSSSSS---SSSSSS-----
-----------------------------o
------------------------------
------------------------------
S------S----------------------
------------------------------
------------------------------
------------------------------
XXXXX--XXXXX-----XXXXXX---X--X