------------------------------
------------------------------
------------------------------
-----XX----------XX-----------
-----XX----------XX-----------
-----XX----------XX-----------
-----XX----------XX-----------
-----XX----------XX-----------
-----XX----------XX-----------
-----XX----------XX-----------
-----XX----------XX-----------
-----XX----------XX------B----
-----XX----------XX------b----
XXXXXXXXXXXXXXXXXXXXXXXXXXXXXX