------------------------------
------------------------------
------------------------------
------------------------------
------------------------------
--S------------SS----S--------
------------------------------
------------------------------
-E-EE--------SS-----E-EE------
-----XX-X---------------XX-X--
-----XX-X---------------XX-X--
-----XX-X---------------XX-X--
-----X--X---------------X--X--
-----X--X--XXXXX-X------X--X--