------------------------------
------------------------------
------------------------------
------------------------------
------------------------------
---------------------XX-------
-----------E---------XX-------
----------<>-------XXXX-------
----------[]-------XXXX----E--
-E--------[]-------XXXX---<>--
<>------E-[]------XXXXX---[]--
[]-----<>-[]------XXXXX---[]--
[]-E---[]-[]--E---XXXXX---[]--
XXXXXXXXXXXXXXXXXXXXXXXXXXXXXX