-----------------------------
-----------------------------
-----------------------------
-----------------------------
-----------------------------
------SSSSSS------SSSS---SSSS
-----------------------------
-----------------E-----------
-----------------------------
---------------S?S-----------
-----------------------------
-----------------------------
-----------------------------
XXXXXXXX-----XXXXXXX---XXXX--