------------------------------
------------------------------
----------------oo------------
--------------------E---------
-------------------XXXX-------
------------oo----------------
------------------------------
------------------------------
o------------XXXXXX-----------
---------X--------------------
---------X--------------------
---------X--------------------
---------X------------------E-
--XXXXX--X---------------XXXXX