------------------------------
------------------------------
------------------------------
------------------------------
------------------------------
------------------------------
------------------------------
------------------------------
------------------------------
------------------------------
------------------------------
-----------------------------X
-EE-E-EE-E-EE-E-EE-EE-E-EE--XX
XXXXXXXXXXXXXXXXXXXXXXXXXXXXXX