------------------------------
------------------------------
------------------------------
------------------------------
------------------------------
----------------SS-----------S
------------------------------
------------------------------
------------------------------
------------------------------
------------------------------
------------------------------
-EE-E-E-EE-E-E----EEEE-E-EE-E-
XXXXXXXXXXXXXXXXXXXXXXXXXXXXXX