------------------------------
------------------------------
------------------------------
------------------------------
------------------------------
--------------XX---SQQS--SSSSS
-------------XXX--------------
------------XXXX--------------
-----------XXXXX--------------
-----------XXXXX----SS--------
---------XXXXXXX--------------
--------XXXXXXXX--------------
---X-------XXXXX--E-E---------
XXXXXXXXXXXXXXXXXXXXXXXXXXX---