------------------------------
------------------------------
------------------------------
------------------------------
------------------------------
------------------------------
------------------------------
------------------------------
------------------------------
------------------------------
------------------------------
----------------------------<-
-EE-E-EE-EE-E-EE-EEEE-E-EE--[-
XXXXXXXXXXXXXXXXXXXXXXXXXXXXXX