------------------------------
------------------------------
------------------------------
------------------------------
------------------------------
------------SSSSSSSSSSSSS-----
------------------------------
------------------------------
------------------------------
-------X----------------------
-----XXX----------------------
----XXXX----------------------
---XXXXX----------------------
XXXXXXXXXXXXXX------------XXXX