---------------------------
---------------------------
---------------------------
---------------------------
---------------------------
---------------S-----------
---------------------------
---------------------------
--------X------------------
-------XX--XX--S-----------
------XXX--XX-------------X
-----XXXX--XXX----X------XX
----XXXXX--XXX----X-----XXX
XXXXXXXXXXXXXXXXXXXXXXXXXXX