------------------------------
------------------------------
------------------------------
------------------------------
-----------oo---E-------------
----------------E--E-----E----
------------------XXXX--XXXXXX
------------------------------
------------------------------
------------XXX---------------
----X-------------------------
----X-------------------------
----X-------------------------
X-XXX--X----------------------