------------------------------
------------------------------
------------------------------
------------------------------
------------------------------
--S---------S-------SSSSSSSSSS
------------------------------
------------------------------
-E-EE------E-EE---------------
-----XX-X------XX-XX----------
-----XX-X------XX-XX----------
-----XX-X------XX-XXX---------
-----X--X------X--XXX---------
-----X--X------X--XXXXX-------