------------------------------
------------------------------
------------------------------
------------------------------
------------------------------
--------------XX---------XX---
-------------XXX--------XXX---
------------XXXX-------XXXX---
-----------XXXXX------XXXXX---
-----S-----XXXXX-----XXXXXX---
---------XXXXXXX----XXXXXXX---
--------XXXXXXXX---XXXXXXXX---
-----------XXXXX--XXXXXXXXX---
XXXXXXXXXXXXXXXXXXXXXXXXXXXXXX