------------------------------
------------------------------
------------------------------
------------------------------
------------------------------
---SSSS------SSSS-------SSS---
------------------------------
------------------------------
------------------------------
S------S--S------S---E-XXXXX--
--------------------<>-X------
--------------------[]-X------
--------------------[]-X------
XXXXX--XXXXXXXX--XXXXXXXXX----