------------------------------
------------------------------
------------------------------
------------------------------
------------------------------
-----SSSSSSSS------SSSSSSSSS--
------------------------------
------------------------------
------------------------------
------------------------------
------------------------------
------------------------------
E---------------E-------------
XXXXXXX-------XXXXXXX--------X