------------------------------
------------------------------
------------------------------
------------------------------
------------------------------
--S-------------SSSSSSSSSSS---
------------------------------
------------------------------
-E-EE-------------------------
-----XX-XXXX------------------
-----XX-XXXX------------------
-----XX-XXXX------------------
-----X--XXXX------------------
-----X--XXXX--XXXX----------XX