------------------------------
------------------------------
------------------------------
------------------------------
------------------------------
---------------------------X-X
----------------------XXX-----
------------------------------
------------------------------
------------------------------
--XX--XXX--XX--XXXXXXXX-------
------------------------------
------------------------------
X---X----X---X----------------