------------------------------
------------------------------
------------------------------
-----X-----XX-----XX----------
-----X-----XX-----XX----------
-----X-----XX-----XX---------S
-----X-----XX-----XX----------
-----X-----XX-----XX----------
-----X-----XX-----XX---------S
-----X-----XX-----XX----------
-----X-----XX-----XX----------
-----X-----XX-----XX----------
-----X-----XX-----XX--E-E-E---
XXXXXXXXXXXXXXXXXXXXXXXXXXXX--