------------------------------
------------------------------
------------------------------
------------------------------
----------------------Eoo-----
------------------E---XXXX----
------------------------------
--------------XX--------------
--E---------------------------
-<>---X-------------XXXXXXX---
-[]---XX----------------------
-[]---XXX-------------------o-
-[]---XXXX-------ooo-------XXX
-XXXXXXXXXXX-----XXX----------