------------------------------
------------------------------
------------------------------
------------------------------
------------------------------
--SQ----SQ--------SQ----SQ----
------------------------------
------------------------------
------------------------------
---S-----S---------S-----S----
------------------------------
------------------------------
-E-E-E-E-E-EEEE--E-E-E-E-E-EEE
XXXXXXXXXXXXXXXXXXXXXXXXXXXXXX