------------------------------
------------------------------
------------------------------
------------------------------
------------------------------
---SSSS------SSSS--------SSSSS
------------------------------
------------------------------
----------------------E-------
S------S--S------S---<>-------
---------------------[]-------
---------------------[]-------
---------------------[]-------
XXXXX--XXXXXXXX--XXXXXXXXXXXX-