------------------------------
------------------------------
------------------------------
------------------------------
------------------------------
-------E-------------E--------
------XXXXXX--------XXXX------
------------------------------
------------------------------
---------------------------E--
--------------------------<>--
--------------------------[]--
-EE-----------------------[]--
XXXX----------XXXX--------XX--