----------------------------
----------------------------
----------------------------
----------------------------
----------------------------
------------------XXXX------
-----------------XXXXX------
----------------XXXXXX------
---------------XXXXXXX--?---
------S--------XXXXXXX------
-X-----------XXXXXXXXX------
-X----------XXXXXXXXXX------
-X-------------XXXXXXX------
-XXXXXXX--XXXXXXXXXXXXXXXXXX