------------------------------
------------------------------
------------------------------
------------------------------
------------------------------
------E---XX--------XX----SSSS
---------XXX-------XXX--------
--------XXXX------XXXX--------
------EXXXXX-----XXXXX--SS----
-----<>XXXXX-----XXXXX--------
-----[]XXXXX---XXXXXXX--------
----X[]XXXXX--XXXXXXXX--------
---XX[]XXXXX-----XXXXX--------
XXXXXXXXXXXXXXXXXXXXXXXXXXX---