------------------------------
------------------------------
----------------oo-----------?
--------------------E---------
-------------------XXXX-------
------SSS---oo----------------
------------------------------
------------------------------
-------------XXXXXX--------SS-
-----XXXXX--------------------
-----X------------------------
-----X------------------------
-----X------------------------
XXXXXXXX-----------------XXXXX