------------------------------
------------------------------
------------------------------
------------------------------
------------------------------
--------------XXXX-----SSSSS--
-------------XXXXX------------
------------XXXXXX------------
-----------XXXXXXX------------
-----------XXXXXXX------------
---------XXXXXXXXX------------
--------XXXXXXXXXX------------
-EE--------XXXXXXX--E---------
XXXXXXXXXXXXXXXXXXXXXXXXX----X