------------------------------
------------------------------
------------------------------
------------------------------
------------------------------
-----------SQQS-------------SQ
------------------------------
------------------------------
------------------------------
------------SS---------------S
------------------------------
------------------------------
-EE--EE-E-E-E----EEEE-E-EE-E-E
XXXXXXXXXXXXXXXXXXXXXXXXXXXXXX