------------------------------
------------------------------
------------------------------
------------------------------
------------------------------
SSSSS-----SSSSSSSSSSSS--------
----------------------------E-
---------------------------<>-
SSSSS----------------------[]-
---------------------------XX-
------------------------------
------------------------------
------------------------------
-----XXXXXXXX----------XXXXXXX