----------------------------
----------------------------
----------------------------
----------------------------
----------------------------
---------SSSSSSSSSSSSSS-----
----------------------------
----------------------------
--E-------------------------
-<>-------------------------
-[]-------------------------
-[]-------------------------
-[]---X-------------------EE
XXXXXXXXXXX-------------XXXX