------------------------
------------------------
------------------------
------------------------
------------------------
--------------S---------
------------------------
------------------------
------------------------
---------Q--QQQQ-------X
----------------------XX
---------------------XXX
--XX----------------XXXX
XXXXXXXXXXXXXXXXXXXXXXXX