------------------------------
------------------------------
------------------------------
------------------------------
------------------------------
------------SSSSS-----S----S--
------------------------------
------------------------------
---------------------E-EEEE-EE
-------X----------------------
-----XXX----------------------
----XXXX----------------------
---XXXXX----------------------
XXXXXXXXXXXXXX----X-----------