------------------------------
------------------------------
------------------------------
------------------------------
------------------------------
--------------------SQSQ--SQ--
------------------------------
------------------------------
------------------------------
---------------------S-S---S--
------------------------------
------------------------------
-EE-E--EE-E-EEEE-E-E-E-E-E-E-E
XXXXXXXXXXXXXXXXXXXXXXXXXXXXXX