-----------------------------
-----------------------------
-----------------------------
-----------------------------
-----------------------------
--S-----------SSSSSSSSSSSSS--
-----------------------------
-----------------------------
-E-EE------------------------
-----XXX-X-------------------
-----XXX-X-------------------
-----XXX-X-------------------
-----XX--X-------------------
-----XX--X--XXXXXXXXXX------X