-----------------------------
-----------------------------
-----------------------------
-----------------------------
-----------------------------
-------------------XXX-------
-----------XXX-----XXX-------
-----------------XXXXX-------
-----------------XXXXX-------
-------XX--------XXXXX-------
----------------XXXXXX-------
----------------XXXXXX-------
----------------XXXXXX-------
XXXXXXX-----XXXXXXXXXXXXXXXXX