------------------------------
------------------------------
------------------------------
------------------------------
------------------------------
--S-----------------SSSSSSSSSS
------------------------------
------------------------------
-E-EE-------------------------
-----XX-X---------------------
-----XX-X---------------------
-----XX-X----E----------------
-----X--X---------------------
-----X--X--X-X-XXXXXXX--------