-----------------------------
-----------------------------
-----------------------------
-----------------------------
-----------------------------
-----------XXX--------XX---SS
-----------XXX-------XXX-----
---------XXXXX------XXXX-----
---------XXXXX-----XXXXX-----
---------XXXXX-----XXXXX-----
--------XXXXXX---XXXXXXX-----
--------XXXXXX--XXXXXXXX-----
-E------XXXXXX-----XXXXX-----
XXXXXXXXXXXXXXXXXXXXXXXXXXXXX