------------------------------
------------------------------
------------------------------
------------------XX-X-------X
------------------XX-X-------X
------------------XX-X-------X
------------------XX-X-------X
------------------XX-X-------X
------------------XX-X-------X
------------------XX-X-------X
------------------XX-X-------X
------------------XX-X-------X
---X----X---EE----XX-X-------X
XXXXXXXXXXXXXXXXXXXXXXXXXXXXXX