------------------------------
------------------------------
------------------------------
------------------------------
------------------------------
SSSSS-----------SSS---------S-
------------------------------
------------------------------
SSSSS---------SS-----------E-E
---------X--------------X-----
---------X--------------X-----
---------X------------X-X-----
---------X------------X-X-----
-----XX--X--XXXXX---X-X-X-----