------------------------------
------------------------------
------------------------------
------------------------------
------------------------------
---SSSS--SS-SSSSSSSSSSS-------
-----------------------------E
----------------------------<>
----------------------------[]
-XX-----X-------------------XX
-XX-----X---------------------
-XXX----X---------------------
-XXX----X---------------------
-XXXXXXXXXXXXX----------XXXXXX