------------------------------
------------------------------
------------------------------
------------------------------
---oo-------------------------
-------oo-----E--------------S
-------------XXXXXXXXX--------
------------------------------
------------------------------
----XXX--XX-------------------
------------------------------
------------------------------
-------------------------EE---
X-----------------------XXXXXX