------------------------------
------------------------------
------------------------------
------------------------------
------------------------------
---------S---------S----------
------------------------------
------------------------------
-oo-----E-EE------E-EE--------
-----X------XX-X------XX-X----
-----X------XX-X------XX-X----
-----X------XX-X------XX-X----
-----X------X--X------X--X----
-----X------X--X------X--X--X-