------------------------------
------------------------------
-------------oo---------------
-----------------E------------
----------------XXXX----------
---------oo-------------------
-----------------------------X
----------------------------XX
----------XXXXXX-----------XXX
---------------------------XXX
------X------------------XXXXX
------X-----------------XXXXXX
------X--------------------XXX
--XXXXX---------------XXXXXXXX