------------------------------
------------------------------
------------------oo----------
----------------------E--E--E-
--------Eoo----------XXXXXXXXX
--------XXXX------------------
------------------------------
------------------------------
----------------XXXXX---------
------XXXXXXX-----------------
------------------------------
--------------o---------------
-XXX---------XXX--------------
------------------------------