------------------------------
------------------------------
------------------------------
------------------------------
------------------------------
--SQ----SQ------SQ------------
------------------------------
------------------------------
------------------------------
---S-----S-------S------------
------------------------------
------------------------------
-E-E-E-E-E-E-E-E-E-E-EEEE-EEEE
XXXXXXXXXXXXXXXXXXXXXXXXXXXXXX