-------------------------
-------------------------
-------------------------
-------------------------
-------------------------
-------------------------
-------------------------
-------------------------
-------------------------
-----------------------E-
------E-------------XX<>-
-------------------XXX[]-
------------------XXXX[]-
XXXXXXXXXXXXXXXXXXXXX-XXX