----------------------------
----------------------------
----------------------------
----------------------------
----------------------------
----------------------------
----------------------------
----------------------------
oo--------------------------
------E---------------------
-----<>------------------E--
-----[]---------------------
-----[]---EE-----E-E--------
----XXXXXXXXX--XXXXXXX--X-XX