------------------------------
------------------------------
------------------------------
------------------------------
------------------------------
------------------------------
------------------------------
------------------------------
---E------E---E------E-------E
--<>--<--<>--<>--<--<>------<>
--[]--[--[]--[]--[--[]------[]
--[]--[--[]--[]--[--[]------[]
-E[]-E[-E[]-E[]-E[-E[]---E-E[]
XXXXXXXXXXXXXXXXXXXXXX--XXXXXX