------------------------------
------------------------------
------------------------------
------------------------------
------------------------------
---SSSS---SSSS---S-SSSS-------
------------------------------
------------------------------
------------------------------
S------S----------------------
------------------------------
------------------------------
-------------------------EEEE-
XXXXX--XXXXX---XXXXXX---XXXXXX