------------------------------
------------------------------
------------------------------
------------------------------
------------------------------
------------------------------
-----------------------oo-----
-------X---------X------------
------XX--------XX---E--------
-----XXX-------XXX--<>--------
----XXXX------XXXX--[]--------
---XXXXX-----XXXXX--[]--------
--XXXXXX----XXXXXX--[]-------X
XXXXXXXXXXXXXXXXXXXXXXXXXXXXXX