--------------------------
--------------------------
--------------------------
--------------------------
--------------------------
-SSS----------S-----------
--------------------------
--------------------------
--------------------------
SSSSS-----XX--S-----------
---------XXX-------------X
--------XXXXX----X------XX
-------XXXXXX----X-----XXX
XXXXXXXXXXXXXXXXXXXXXXXXXX