------------------------------
------------------------------
------------------------------
------------------------------
------------------------------
--SQ--SQ----SQ--SQ----------S-
------------------------------
------------------------------
------------------------------
---S---S-----S---S------------
------------------------------
------------------------------
-E-E-E-E-E-E-E-E-E-EE-EE-E-E-E
XXXXXXXXXXXXXXXXXXXXXXXXXXXXXX