------------------------------
------------------------------
------------------------------
------------------------------
---oo--oo---------------------
---------------SSSSSSSSSS-----
------------------------------
------------------------------
------------------------------
----XXX-----------------------
------------------------------
--------XXX-------------------
----------------------------EE
X------------XXXX---------XXXX