------------------------------
------------------------------
------------------------------
--XX---XX----XXXX-------------
--XX---XX----XXXX-------------
--XX---XX----XXXX--SSSS----SS-
--XX---XX----XXXX-------------
--XX---XX----XXXX-------------
--XX---XX----XXXX-------------
--XX---XX----XXXX-------------
--XX---XX----XXXX-------------
--XX---XX----XXXX-------------
--XX---XX----XXXX-------------
XXXXXXXXXXXXXXXXXXX----XXXX--X