------------------------------
------------------------------
------------------------------
------------------------------
------------------------------
-------E---XX--SSSS---SSSSSSSS
----------XXX-----------------
---------XXXX-----------------
-------EXXXXX-----------------
------<>XXXXX-----------------
------[]XXXXX-----------------
-----X[]XXXXX-----------------
----XX[]XXXXX-----------------
XXXXXXXXXXXXXXXXX---XXXXXXX---