------------------------------
------------------------------
------------------------------
------------------------------
------------------------------
--SS--SSS---------SS---S------
------------------------------
------------------------------
-----------------------------E
----------------------------<>
----------------------------[]
----------------------------[]
----------------------------[]
XX--XX---XXXXXXXXX--XXX-XXXXXX