------------------------------
------------------------------
------------------------------
------------------------------
------------------------------
SS------SSS----S----------S---
------------------------------
------------------------------
SS------------E-EE-------E-EE-
------------------XX-X-------X
------------------XX-X-------X
------------------XX-X-------X
----X-------------X--X-------X
--XXXXXXXX-X------X--X-------X