-----------------------------
-----------------------------
-----------------------------
-----------------------------
-----------------------------
-----------------------------
-----------------------------
-----------------------------
-----------------------------
-----------------------------
----------------E------X-----
---------------<>------X-----
-XXXXXXXXXX----[]------X-----
-------------XXXXXXXXXXX---XX