------------------------------
------------------------------
------------------------------
------------------------------
------------------------------
--------------------SSSS-S----
------------------------------
------------------------------
------------------------------
------------------------------
------------------------------
------------------------------
-EE-E-EE-EE-EEEE-E-----------E
XXXXXXXXXXXXXXXXXXXXXX-----XXX