-------------------------
-------------------------
-------------------------
-------------------------
-----------------------E-
-----Q----?-----SSSSSSSSS
-------------------------
---------------E---------
-------------------------
---S?SQS--Q--S?S---------
-------------------------
-------------------------
----E--------------------
XXXXXXXXXXXXXXXXXXXXXXXXX