-------------------------
-------------------------
-------------------------
-------------------------
-------------------------
-----------------XXXX----
----------------XXXXX----
---------------EXXXXX----
--------------XXXXXXX----
-------------XXXXXXXX----
-----B-----EXXXXXXXXX----
-----b-----XXXXXXXXXX----
E----B----XXXXXXXXXXX----
XXXXXXXXXXXXXXXXXXXXXXXXX