------------------------------
------------------------------
------------------------------
------------------------------
------------------------------
-SSS----------XX-----XX-------
-------------XXX-----XX-------
------------XXXX---XXXX-------
-----------XXXXX---XXXX-------
-SSSS------XXXXX---XXXX---X---
---------XXXXXXX--XXXXX---XX--
--------XXXXXXXX--XXXXX---XXX-
-----------XXXXX--XXXXX---XXXX
XXXXXXXXXXXXXXXXXXXXXXXXXXXXXX