------------------------------
------------------------------
------------------------------
------------------------------
------------------------------
-------S---------S---------S--
------------------------------
------------------------------
-o----E-EE------E-EE------E-EE
----------XX-X------XX-X------
----------XX-X------XX-X------
----------XX-X------XX-X------
----------X--X------X--X------
---X------X--X------X--X------