------------------------------
------------------------------
------------------------------
------------------------------
---oo---E---------------------
--------E------SSSSSSSS-------
----------XXX-----------------
------------------------------
------------------------------
----XXX-----------------------
------------------------------
------------------------------
---------------------------E--
X----------XXXXXX-------XXXXX-