------------------------------
------------------------------
-----------oo-----------------
---------------E--E--E--------
--------------XXXXXXXXXX------
-------oo---------------------
------------------------------
------------------------------
--------XXXXXX----------------
------------------------------
----X-------------------------
----X-------------------------
----X------------------------E
XXXXX---------------------XXXX