------------------------------
------------------------------
------------------------------
------------------------------
------------------------------
--SS---SS---------------------
------------ooo---------------
------------------------------
------------------------------
------------------E-E-E-------
-----------------<><><>---E---
-----------------[][][]--<>---
-----------------[][][]--[]---
XX--XXX--X--XXXXXXXXXXXXXXXXXX