------------------------------
------------------------------
------------------------------
------------------------------
------------------------------
--SQ----SQ--------------------
------------------------------
------------------------------
------------------------------
---S-----S--------------------
------------------------------
------------------------------
-E-E-E-E-E-E-EE-E-EEEE-EE-EEEE
XXXXXXXXXXXXXXXXXXXXXXXXXXXXXX