------------------------------
------------------------------
------------------------------
------------------------------
-----------------------XX-----
------------------------------
---------------------E--------
-------------------XXXX-------
------------------------------
------------------------------
--XX--X----XX--X-----------X-X
------------------------------
------------------------------
X---X--X-X---X--X-------------