------------------------------
------------------------------
------------------------------
------------------------------
------------------------------
SSSS--SSS-----SSSSSSSSSSS-----
------------------------------
------------------------------
SSSS--------------------------
------------XX----------------
------------XX----------------
------------XXX---------------
------------XXX---------------
----XXXX-X--XXXXX---------XXXX