------------------------------
------------------------------
------------------------------
--XX--X---XX--X--------XX-X--X
--XX--X---XX--X--------XX-X--X
--XX--X---XX--X--------XX-X--X
--XX--X---XX--X--------XX-X--X
--XX--X---XX--X--------XX-X--X
--XX--X---XX--X--------XX-X--X
--XX--X---XX--X--------XX-X--X
--XX--X---XX--X--------XX-X--X
--XX--X---XX--X--------XX-X--X
--XX--X---XX--X-----E--XX-X--X
XXXXXXXXXXXXXXXXXXXXXXXXXXXXXX