--------------------------
--------------------------
--------------------------
--------------------------
--------------------------
-------SSSSSSSSSSSSSS-----
--------------------------
--------------------------
--------------------------
--------------------------
--------------------------
--------------------------
-EE---------------------EE
XXXXXXXXX-------------XXXX