------------------------------
------------------------------
------------------------------
------------------------------
------------------------------
SSS---------------S----S------
------------------------------
-------------X----------------
SSS----------X---E-EEEE-EEEEEE
-----XXX-----X----------------
-----XXX-----X----------------
-----XXX-----X----------------
-----XXX-----X----------------
---XXXXX-----X----------------