------------------------------
------------------------------
------------------------------
------------------------------
------------------------------
----------E-------E-----E-----
---------XXXXXX--XXXX--XXXX---
------------------------------
----S-------------------------
------------------------------
------------------------------
------------------------------
EE---------------------------X
XXXXXXX-----------------------