------------------------------
------------------------------
------------------------------
------------------------------
------------------------------
------------------------------
------------------------------
-----XX--------XX----------XX-
-----XX--------XX----------XX-
S----XXS-SS----XXS-SS------XXS
----XXX-------XXX---------XXX-
----XXX-------XXX---------XXX-
----XXX-------XXX---------XXX-
XXXXXXXXXXXXXXXXXXXXXXXXXXXXXX