------------------------------
------------------------------
------------------------------
------------------------------
------------------------------
-------------SSSSSSSSSS-------
-----------------------------E
----------------------------<>
-----o----------------------[]
----------------------------XX
------------------------------
------------------------------
------------------------------
--XX---XX-XXXXX---------XXXXXX