------------------------------
------------------------------
------------------------------
------------------------------
------------------------------
---------?S---------?SS-------
------------------------------
------------------------------
---E---E------E---E-----------
--<>--<>-----<>--<>-----X---<-
--[]--[]--B--[]--[]--B--X---[-
--[]--[]--b--[]--[]--b--X---[-
-E[]-E[]--B-E[]-E[]--B--X--E[E
XXXXXXXXXXXXXXXXXXXXXXXXXXXXXX