-----------------------------
-----------------------------
-----------------------------
-----------------------------
-----------------------------
-----------XXX---------------
----------XXXX-------------XS
---------XXXXX------------XXX
--------XXXXXX-----------XXXS
-------XXXXXXX----------XXXXX
------XXXXXXXX---------XXXXXX
--<>-XXXXXXXXX--------XXXXXXX
--[]XXXXXXXXXX-------XXXXXXXX
XXXXXXXXXXXXXXXXXXXXXXXXXXXXX