------------------------------
------------------------------
------------------------------
------------------------------
------------------------------
------E---XX-----------XXXX---
---------XXX----------XXXXX---
--------XXXX---------XXXXXX---
------EXXXXX--------XXXXXXX---
-----<>XXXXX--------XXXXXXX---
-----[]XXXXX------XXXXXXXXX---
----X[]XXXXX-----XXXXXXXXXX---
---XX[]XXXXX--------XXXXXXX---
XXXXXXXXXXXXXX-XXXXXXXXXXXXXXX