------------------------------
------------------------------
-----------oo-----------------
---------------E--E--E--------
--------------XXXXXXXXXX------
-------oo---------------------
------------------------------
----X-------------------------
----X---XXXXXX----------------
--X-X-------------------------
--X-X-------------------------
--X-X-------------------------
--X-X-------------------------
--X-X---------------------XXXX