-------------------------
-------------------------
-------------------------
-------------------------
-------------------------
---------------------SSSS
-------------------------
-------------------------
----------------Q-----E--
---------------E----SSSSS
---------------E---------
-------------------------
-E-E-EE------------------
XXXXXXXXXXXXXXXXXXXXXXXXX