-------------------------
-------------------------
-------------------------
-------------------------
-------------------------
----------------XX-------
---------------XXX-------
--------------XXXX-------
-------------XXXXX-------
------------XXXXXX----Q--
-----------XXXXXXX-------
----------XXXXXXXX-------
--E-E----XXXXXXXXX-------
XXXXXXXXXXXXXXXXXXXXXXXXX