-----------------------------
-----------------------------
-----------------------------
-----------------------------
-----------------------------
-----------XXX--------XX---SS
-----------XXX-------XXX-----
---------XXXXX------XXXX-----
---------XXXXX-----XXXXX-----
---------XXXXX-----XXXXX-----
--------XXXXXX---XXXXXXX-----
-X------XXXXXX--XXXXXXXX-----
-X--EE--XXXXXX-----XXXXX-----
XXXXXXXXXXXXXXXXXXXXXXXXXXXXX