----------------------------
----------------------------
----------------------------
----------------------------
----------------------------
----------------S-----------
----------------------------
----------------------------
---------X------------------
--------XX--XX--S-----------
-----X-XXX--XX-------------X
----XXXXXX--XXX----X------XX
---XXXXXXX--XXX----X-----XXX
XXXXXXXXXXXXXXXXXXXXXXXXXXXX