------------------------------
------------------------------
------------------------------
------------------------------
------------------------------
--S-------SSS--SSSSSSSSSS-----
------------------------------
------------------------------
-E-EE-------------------------
-----XX-XX--------------------
-----XX-XX--------------------
-----XX-XXX-------------------
-----X--XXX-------------------
-----X--XXXXXXXXXX--------XXXX