------------------------------
------------------------------
------------------------------
------------------------------
------------------------------
--S-----------------S-------S-
------------------------------
------------------------------
-E-EE-E------------E-EE----E-E
-----X-XXX-----XX------XX-----
-----X-XXX-----XX------XX-----
-----X-XXX-----XX------XX-----
-----X-X-------XX------X------
-----X-X----XXXXX------X------