------------------------------
------------------------------
------------------------------
------------------------------
------------------------------
-----S-----S---------S--------
------------------------------
------------------------------
----E-----E-EE------E-EEEEEE--
--------------XX-X------------
--------------XX-X------------
--------------XX-X------------
--------------X--X------------
XX----XX------X--X----------XX