------------------------------
------------------------------
------------------------------
------------------------------
------------------------------
---SSSSS-----SSSSS-----------S
------------------------------
------------------------------
------------------------------
S-------S-S-------S---<>------
----------------------[]------
----------------------[]------
----------------------[]------
XXXXX---XXXXXXX---XXXXXXXXXXXX