--------------------------
--------------------------
--------------------------
--------------------------
--------------------------
--------------------------
--------------------------
--------------------------
----SS----------------o---
--------------------------
--------------------------
--------------------------
EE-------E------XXXX-----X
XXXXXXXXXXXXXX------------