------------------------------
------------------------------
------------------------------
------------------------------
------------------------------
--------------E-----E---------
------XXX----XXXX--XXXX-------
------------------------------
------------------------------
------------------------------
------------------------------
------------------------------
E-E----------------------XXX--
XXXX---XXXX-------------------