-----------------------------
-----------------------------
-----------------------------
-----------------------------
-----------------------------
-------------XX---SQQS--SSSSS
------------XXX--------------
-----------XXXX--------------
---E------XXXXX--------------
--<>------XXXXX----SS--------
--[]----XXXXXXX--------------
--[]---XXXXXXXX--------------
--[]------XXXXX--E-E---------
XXXXXXXXXXXXXXXXXXXXXXXXXX---