------------------------------
------------------------------
------------------------------
------------------------------
------------------------------
--SS--SSS-----SS---SS----SS-S-
------------------------------
------------------------------
------------------------------
------------------------------
------------------------------
------------------------------
------------------------------
XX--XX---XXXXX--XXX--XXXX--X-X