-------------------------
-------------------------
-------------------------
-------------------------
-------------------------
-------------------------
-------------------------
-------------------------
--------------X----------
--Q----------EX----------
------------XXX----------
-----------XXXX----B-----
---------XXXXXX----b-----
XXXXXXXXXXXXXXXXXXXXXXXXX