------------------------------
------------------------------
------------------------------
------------------------------
------------------------------
----------SS------------SS----
------------------------------
------------------------------
------------------------------
----------SS----X-------------
----------------X-------------
----------------X-------------
-EE---E-E----E--X---------E---
XXXXXXXXXXXXXXXXXXXXX-XXXXXX--