------------------------------
------------------------------
------------------------------
------------------------------
------------------------------
--S----SSSSS---SSSSSSSSSSSSS--
------------------------------
------------------------------
-E-EE-------------------------
-----XX-----------------------
-----XX-----------------------
-----XXX----------------------
-----XXX----------------------
-----XXXXX---XXXX------------X