------------------------------
------------------------------
------------------------------
------------------------------
------------------------------
-----SS-----S---------S-------
------------------------------
------------------------------
oo---SS----E-EE------E-EE-----
---------------XX-X------XX-X-
---------------XX-X------XX-X-
---------------XX-X------XX-X-
---------------X--X------X--X-
---X---XX------X--X------X--X-