------------------------------
------------------------------
------------------------------
------------------------------
------------------------------
-------E---XX--------XXXX--?--
----------XXX-------XXXXX-----
---------XXXX------XXXXXX-----
-------EXXXXX-----XXXXXXX-----
------<>XXXXX-----XXXXXXX--Q--
------[]XXXXX---XXXXXXXXX-----
-----X[]XXXXX--XXXXXXXXXX-----
----XX[]XXXXX-----XXXXXXX-----
XXXXXXXXXXXXXXXXXXXXXXXXXXXXXX