------------------------------
------------------------------
------------------------------
------------------------------
---oo---E---------------------
--------E--E------------------
----------XXXXXXX----E--E--E--
-------------------XXXXXXXXXXX
------------------------------
----XXX-----------------------
------------------------------
------------------------------
------------------------------
X-----------------------------