------------------------------
------------------------------
------------------------------
------------------------------
------------------------------
-----------XX--SSSSSSSSSSS----
----------XXX-----------------
---------XXXX-----------------
--------XXXXX-----------------
--------XXXXX-----------------
------XXXXXXX-----------------
-----XXXXXXXX-----------------
--------XXXXX-----------------
XXXXXXXXXXXXXXXXX----------XXX