------------------------------
------------------------------
------------------------------
------------------------------
------------------------------
---SSSSS---SSSSSSSSSSS---SSSSS
------------------------------
------------------------------
------------------------------
S-------S---------------------
------------------------------
------------------------------
------------------------------
XXXXX---XXXXX----------XXXX---