-------------------------
-------------------------
-------------------------
-------------------------
-------------------------
-------------------------
-------------------------
----o--------------------
-----------------------o-
-SSS---------------------
-------------------------
-------------------------
-------E---------EE------
-XXXXXXXXXXXXXXXXXXXX----