------------------------------
------------------------------
------------------------------
------------------------------
------------------------------
------SSS-----------XXXX------
-------------------XXXXX------
------------------XXXXXX------
-----------------XXXXXXX--?---
-----XXXXX-------XXXXXXX------
-----X---------XXXXXXXXX------
E----X--------XXXXXXXXXX------
-----X-----------XXXXXXX------
X-XXXXXX----XXXXXXXXXXXXXXXXXX