------------------------------
------------------------------
------------------------------
------------------------------
------------------------------
--------------------SSSSSSS---
------------------------------
------------------------------
---E-----E--------------------
--<>----<>------------------S-
--[]----[]--------------------
--[]----[]--------------------
E-[]E-E-[]E--E--EE------------
XXXXXXXXXXXXXXXXXXXXXX-X----XX