------------------------------
------------------------------
------------------------------
------------------------------
------------------------------
-----------------------XXXX---
----------------------XXXXX---
--------------X------XXXXXX---
-------------XX-----XXXXXXX---
-------X-----XX-----XXXXXXX---
-----XXX---XXXX---XXXXXXXXX---
----XXXX--XXXXX--XXXXXXXXXX---
---XXXXX-----XX-----XXXXXXX---
XXXXXXXXXXXXXXXXXXXXXXXXXXXXXX