--------------------------
--------------------------
--------------------------
--------------------------
--------------------------
--------------------XXX---
-------------------XXXX---
-------X----------XXXXX---
------XX---------XXXXXX---
-----XXX--------XXXXXXX---
----XXXX-------XXXXXXXX---
---XXXXX---<>-XXXXXXXXX---
--XXXXXX---[]XXXXXXXXXX---
XXXXXXXXXXXXXXXXXXXXXXXXXX