------------------------------
------------------------------
------------------------------
------------------------------
------------------------------
--------XXX-------SSSSSS---SSS
-------XXXX-------------------
------XXXXX-------------------
-----XXXXXX---o---------------
-----XXXXXX-------------------
---XXXXXXXX-------------------
--XXXXXXXXX-------------------
-----XXXXXX-------------------
XXXXXXXXXXXXX---XXXX-----XXXX-