------------------------------
------------------------------
------------------------------
------------------------------
------------------------------
SSSS--SSSSS-----------XXXX--?-
---------------------XXXXX----
--------------------XXXXXX----
SSSS---------------XXXXXXX----
-------------------XXXXXXX--Q-
-----------------XXXXXXXXX----
----------------XXXXXXXXXX----
-------------------XXXXXXX----
----XXXX----X-XXXXXXXXXXXXXXXX