------------------------------
------------------------------
------------------------------
------------------------------
------------------------------
-------SSSS----SSSSSSSSS------
------------------------------
-----------------------------<
--E--SS----------------------[
-<>--------------------------X
-[]---------------------------
-[]---------------------------
-[]---------------------------
-XXXXXXX----XXXXX--------XXXXX