------------------------------
------------------------------
------------------------------
------------X------------XX---
------------X------------XX---
--SS----SS--X--SS----SS--XX---
------------X------------XX---
------------X------------XX---
------------X------------XX---
------------X------------XX---
------------X------------XX--<
------------X------------XX--[
------------X------------XX--[
XX--XXXX--XXXXX--XXXX--XXXXXXX