------------------------------
------------------------------
------------------------------
------------------------------
------------------------------
------------------------------
---------------XXXXX----------
----------------------------XX
------------------------------
------------------------------
--XX--X--XX--XXX--------X-XXX-
-------------------XXX--------
------------------------------
X---X--X---X------------------