------------------------------
------------------------------
------------------------------
------------------------------
------------------------------
SSS-----SSSSS-----S---------S-
------------------------------
------------------------------
SSS---SS---------E-EE------E-E
---------------------XX-X-----
---------------------XX-X-----
---------------------XX-X-----
---------------------X--X-----
---XXXXXX-----X------X--X-----