------------------------------
------------------------------
------------------------------
------------------------------
------------------------------
-----------XX--------XX----SSS
----------XXX-------XXX-------
---------XXXX------XXXX-------
--------XXXXX-----XXXXX--SS---
--------XXXXX-----XXXXX-------
------XXXXXXX---XXXXXXX-------
-----XXXXXXXX--XXXXXXXX-------
--------XXXXX-----XXXXX-------
XXXXXXXXXXXXXXXXXXXXXXXXXXXX--