------------------------------
------------------------------
------------------oo----------
----------------------E--E--E-
----Eoooooo----------XXXXXXXXX
----XXXXXXXX------------------
------------------------------
------------------------------
----------------XXXXX---------
-XXXXXXXXXXXX-----------------
------------------------------
--------------o---------------
-------------XXX--------------
------------------------------