------------------------------
------------------------------
------------------------------
------------------------------
---oo-------------------------
-----------E---------------SSS
----------XXXXXXXXXX----------
------------------------------
------------------------------
----XXXX----------------------
------------------------------
------------------------------
-----------------------EE-----
X---------------------XXXXXXX-