------------------------------
------------------------------
------------------------------
------------------------------
------------------------------
SSSSS--------S----------S-----
------------------------------
------------------------------
SSSSS-------E-EE-------E-EE---
----------------XX-X-------XX-
----------------XX-X-------XX-
----------------XX-X-------XX-
-------X--------X--X-------X--
-----XXXXX------X--X-------X--