------------------------------
------------------------------
------------------------------
------------------------------
------------------------------
--------SS-----SSSSSSS---SSSSS
------------------------------
---X--------------------------
---X----SS--------------------
-X-X--------------------------
-X-X--------------------------
-X-X--------------------------
-X-X--------------------------
-X-X--X---XX-XXXX------XXXX---