------------------------------
------------------------------
------------------------------
------------------------------
------------------------------
---SSSSS---SSSSSS----SSSSSSS--
------------------------------
------------------------------
------------------------------
S-------S---------------------
------------------------------
------------------------------
------------------------------
XXXXX---XXXXX-----XXXXX------X