------------------------------
------------------------------
------------------------------
------------------------------
------------------------------
SSSS------------SSSSSSSSS-----
------------------------------
----------X-------------------
SSSS-----XX-------------------
---------XX-------------------
-------XXXX-------------------
------XXXXX-------------------
---------XX-------------------
----XXXXXXXXX-XXXX--------XXXX