------------------------------
------------------------------
------------------------------
------------------------------
------------------------------
---------SSSSSS---SSSSSSSSS---
------------------------------
------------------------------
oo----------------------------
------------------------------
------------------------------
------------------------------
------E-----------------------
-----XXXXXX-----XXXX--------XX