------------------------------
------------------------------
------------------------------
------------------------------
------------------------------
--SS----SS-------SS---SSSSSSSS
------------------------------
------------------------------
------------------------------
------------------------------
------------------------------
------------------------------
------------------------------
XX--XXXX--XX-XXXX--XXX--------