------------------------------
------------------------------
------------------------------
------------------------------
------------------------------
SSSS-----S---------S---------S
------------------------------
------------------------------
SSSS----E-EE------E-EE------E-
------------XX-X------XX-X----
------------XX-X------XX-X----
------------XX-X------XX-X----
------------X--X------X--X----
----XX------X--X------X--X----