------------------------------
------------------------------
------------------------------
------------------------------
------------------------------
-------E-------E-----E--------
------XXXXXX--XXXX--XXXX------
------------------------------
------------------------------
----------------------------<>
----------------------------[]
----------------------------[]
-EE-------------------------[]
XXXX----------------------XXXX