------------------------------
------------------------------
------------------------------
------------------------------
------------------------------
---SSS---SSSS-----SSS---------
------------------------------
------------------------------
---SSS---SSSS-----SSS---------
------------------------------
--------------------------XX--
------------------------------
E-----E-----------------------
XX----XX-----XX-X----XX-X---X-