------------------------------
------------------------------
------------------------------
------------------------------
------------------------------
---SSS---SS---SSS---SSS---SSSS
------------------------------
------------------------------
---SSS---SS---SSS---SSS---SSSS
------------------------------
------------------------------
------------------------------
E-----E----E-----E------------
XX----XX---XX----XX----XX-----