-------------------------
-------------------------
-------------------------
-------------------------
-------------E-----------
---------SSSSSSSSS-------
-------------------------
--------E----------------
-------------------------
------S?S-------------Q--
-------------------------
-<>----------------------
-[]----------------------
XXXXXXXXXXXXXXXX---XXXXXX