------------------------------
------------------------------
------------------------------
------------------------------
------------------------------
SSS------SSSSSSSSSSSSS--------
----------------------------E-
---------------------------<>-
SSS------------------------[]-
---------------------------XX-
------------------------------
------------------------------
------------------------------
---XXXXXXXX------------XXXXXXX