------------------------------
------------------------------
------------------------------
------------------------------
------------------------------
--SS--S--SS--SS------------SS-
------------------------------
------------------------------
------------------------------
---------------------------SS-
------------------------------
------------------------------
-------------------EEEE-------
XX--XX-XX--XX--XXXXXXXXXXXXXXX