------------------------------
------------------------------
------------------------------
------------------------------
------------------------------
SSSS----SSSSSS---SSSSSSSSS----
------------------------------
------------------------------
SSSS--SS----------------------
------------------------------
------------------------------
------------------------------
------------------------------
----XXXXX------XXXX--------XXX