-----------------------
-----------------------
-----------------------
-----------------------
-----------------------
-----------------------
-----------------------
-----------------------
-------E---------------
------<>--------------X
------[]-------------XX
------[]------------XXX
------[]-----------XXXX
XXXXXXXXXXXXXXXXXXXXXXX