------------------------------
------------------------------
------------------------------
------------------------------
------------------------------
----------X----------XX-------
---------XX---------XXX-------
--------XXX--------XXXX-------
-------XXXX-------XXXXX-------
------XXXXX------XXXXXX-------
-----XXXXXX-----XXXXXXX-------
----XXXXXXX----XXXXXXXX-------
E--XXXXXXXXE--XXXXXXXXX----XE-
XXXXXXXXXXXXXXXXXXXXXXXXXXXXXX