------------------------------
------------------------------
------------------------------
------------------------------
------------------------------
SSS--SSSSS---SSSSSSSSSSS------
------------------------------
-----------------------------<
SSS--------------------------[
-----------------------------X
------------------------------
------------------------------
------------------------------
---XXXXX---XXXX----------XXXXX