-------------------------
-------------------------
-------------------------
-------------------------
-------------------------
----Q--------------------
-------------------------
-------------------------
-------------------------
--S?SQS-----------<>-----
------------------[]-----
------------------[]-----
---E-------E-EE-E-[]-----
XXXXXXXXXXXXXXXXXXXXXXXXX