------------------------------
------------------------------
------------------------------
------------------------------
------------------------------
-------------------------S---S
------------------------------
------------------------------
----------------E------------S
---------------<>--------S----
---------------[]-------------
---------------[]-------------
--E--E---E--E--[]-E-E--E------
XXXXXXXXXXXXXXXXXXXXXXXXXXXX--