-------------------------
-------------------------
-------------------------
-------------------------
-------------------------
-------------------------
-------------------------
---------------------XSS-
--------------------XXX--
-----E-X-----------XXXX-S
----<>-XX---------XXXXX--
----[]-XXX-------XXXXXX--
-E--[]-XXXX-----XXXXXXX--
XXXXXXXXXXXXXXXXXXXXXX---