------------------------------
------------------------------
------------oo----------------
----------------E--E--E-------
---------------XXXXXXXXXX-----
--------oo--------------------
------------------------------
------------------------------
---------XXXXXX---------------
------------------------------
------------------------------
------------------------------
--XXXX------------------------
---------------------------XXX