------------------------------
------------------------------
------------------------------
------------------------------
------------------------------
SSSS--SSSSSSSS-----S---------S
------------------------------
------------------------------
SSSS--------------E-EE------E-
----------------------XX-X----
----------------------XX-X----
----------------------XX-X----
----------------------X--X----
----XXXX-------X------X--X----