------------------------------
------------------------------
------------------------------
------------------------------
------------------------------
SSSSS-----SSSSSSS---SSSSSSSSS-
------------------------------
------------------------------
SSSSS-------------------------
------------------------------
------------------------------
------------------------------
-------X----------------------
-----XXXXXXX------XXXX--------