------------------------------
------------------------------
------------------------------
------------------------------
------------------------------
-------------XXX--------XX---S
-------------XXX-------XXX----
-----------XXXXX------XXXX----
-----------XXXXX-----XXXXX----
-------X---XXXXX-----XXXXX----
------XX--XXXXXX---XXXXXXX----
--<>-XXX--XXXXXX--XXXXXXXX----
--[]XXXX--XXXXXX-----XXXXX----
XXXXXXXXXXXXXXXXXXXXXXXXXXXXXX