------------------------------
------------------------------
------------------------------
--XX-----XX-------------------
--XX-----XX-------------------
--XX-----XX-------------------
--XX-----XX------------oo-----
--XX-----XX-------------------
--XX-----XX----------E--------
--XX-----XX---------<>-----Q-Q
--XX-----XX---------[]--------
--XX-----XX---------[]--------
--XX-----XX---------[]--------
XXXXXXXXXXXXXXXXXXXXXXXXXXXXXX