---------------------------
---------------------------
---------------------------
---------------------------
---------------------------
---------------------XXX---
--------------------XXXX---
-------------------XXXXX---
------------------XXXXXX---
----X------------XXXXXXX---
----XX----------XXXXXXXX---
----XXX-----<>-XXXXXXXXX---
----XXXX----[]XXXXXXXXXX---
XXXXXXXXXXXXXXXXXXXXXXXXXXX