------------------------------
------------------------------
------------------------------
------------------------------
------------------------------
---SSSS---SSSSSSSS-----------S
------------------------------
------------------------------
-----------------------oo-----
S------S----------------------
------------------------------
------------------------------
------------------------------
XXXXX--XXXXX-------X------XXXX