------------------------------
------------------------------
------------------------------
------------------------------
------------------------------
----------S-------------------
------------------------------
---X--------------------------
---X-----E-EEE----------------
-X-X----------XX-X------------
-X-X----------XX-X------------
-X-X----------XX-X------------
-X-X----------X--X------------
-X-X----------X--X-----XXX----