-------------------------
-------------------------
-------------------------
-------------------------
-------------------------
SS-------------SSSSSSS---
-------------------------
--------------E----------
SS-----------------------
------------S?S----------
---------E--------------E
-------------------------
-------------------------
--XXXXXXXXXXXXXXXXX----X-