------------------------------
------------------------------
------------------------------
------------------------------
------------------------------
-----X-----X-----X-----XXXX---
------------------------------
------------------------------
---------------------------XX-
------------------------------
------------------------------
------------------------------
------------------------------
XXX---XXX---XXX---XXX--------X