------------------------------
------------------------------
------------------------------
------------------------------
------------------------------
-----------------S---------S--
------------------------------
------------------------------
-oo-----o-------E-EE------E-EE
-----X--------------XX-X------
-----X--------------XX-X------
-----X--------------XX-X------
-----X------E-------X--X------
-----X-----XXX------X--X------