------------------------------
------------------------------
------------------------------
------------------------------
------------------------------
--------E--------E-----------E
-------XX-------XXXX--------XX
------------------------------
------------------------------
------------------------------
------------------------------
------------------------------
---XX-------XX--------XXXX----
X--------X--------------------