------------------------------
------------------------------
------------------------------
------------------------------
------------------------------
-----S-------S-------------S--
------------------------------
---------------------X--------
----E-EE----E-EE-----X--E-E-EE
----------------XX-X-X--------
----------------XX-X-X--------
----------------XX-X-X--------
----------------X--X-X--------
XX------XX------X--X-X--------