--------------------------
--------------------------
--------------------------
--------------------------
--------------------------
-----S--------------XXX---
-------------------XXXX---
------------------XXXXX---
-----------------XXXXXX---
-----S----------XXXXXXX---
---------------XXXXXXXX---
-----------<>-XXXXXXXXX---
--X--------[]XXXXXXXXXX---
XXXXXXXXXXXXXXXXXXXXXXXXXX