------------------------------
------------------------------
------------------------------
------------------------------
------------------------------
--------XX-----XX--SSSSSSSSS--
--------XX-----XX-------------
------XXXX---XXXX-------------
------XXXX---XXXX-------------
------XXXX---XXXX-------------
-----XXXXX--XXXXX-------------
-----XXXXX--XXXXX-------------
E----XXXXX--XXXXX-------------
XXXXXXXXXXXXXXXXXXXXXXX------X