-----------------------------
-----------------------------
-----------------------------
-----------------------------
-----------------------------
SSSS-----------SSSSSSSSSSSS--
-----------------------------
-----------------------------
SSSS-------------------------
---------XX------------------
--------XXX------------------
-------XXXX------------------
------XXXXX------------------
----XXXXXXX--XXXXXXXXX------X