------------------------------
------------------------------
------------------------------
------------------------------
------------------------------
--S----------SSSSSSS-----S----
------------------------------
------------------------------
-E-EE-------------------E-EE--
-----XX-X-------------------XX
-----XX-X-------------------XX
-----XX-X-------------------XX
-----X--X-------------------X-
-----X--X--XXXX------X------X-