------------------------------
------------------------------
------------------------------
------------------------------
------------------------------
-----------E-----E------------
----------XXXX--XXXX----------
------------------------------
------------------------------
------------------------------
------------------------------
------------------------------
EE-E------------------XXX--XX-
XXXXX--X----------------------