------------------------------
------------------------------
------------------------------
------------------------------
--------------oo------E-------
----------------------E--E----
------------------------XXXX--
------------------------------
------------------------------
---------------XXXXXX---------
------------------------------
------------------------------
---XX-----XX------------------
X------X----------------------