------------------------------
------------------------------
-----------oo-----------------
---------------E--E--E--------
--------------XXXXXXXXXX------
-------oo---------------------
------------------------------
------------------------------
o-------XXXXXX----------------
------------------------------
------------------------------
------------------------------
---XX-------------------------
--------------------------XXXX