------------------------------
------------------------------
------------------------------
------------------------------
------------------------------
--S--------SSSSSSSSSSSSS------
------------------------------
-----------------------------<
-E-EE------------------------[
-----XX----------------------X
-----XX-----------------------
-----XX-----------------------
-----X------------------------
-----X---XXXX------------XXXXX