--------------------------
--------------------------
--------------------------
--------------------------
--------------------------
--------------------------
---------E--E----E--------
----X--XXXXXXXXXXXXXXXXXX-
----X---------------------
--X-X---------------------
--X-X---------------------
--X-X---------------------
--X-X---------------------
--X-X---------------------