------------------------------
------------------------------
------------------------------
------------------------------
------------------------------
--------XX---------SSSSSSSSS--
-------XXX--------------------
------XXXX--------------------
-----XXXXX--------------------
-----XXXXX--------------------
---XXXXXXX--------------------
--XXXXXXXX--------------------
-----XXXXX--EE-EE-------------
XXXXXXXXXXXXXXXXXXXXX--------X