-------------------------
-------------------------
-------------------------
-------------------------
-------------------------
-------------------------
-------------------------
-------------------------
-------------------------
------QQQ------------E---
--------------------<>---
--------------------[]---
--------------------[]---
XXXXXXXXXXXXXXXXXX-XXXXXX