-------------------------
-------------------------
-------------------------
-------------------------
-------------------------
-------------------------
-------------------------
-------------------------
---------------o---------
-------------E--------E--
--------E---<>-------<>--
------------[]-------[]--
------------[]-------[]--
XXXXXX-X-XXXXXXXXXXXXXXXX