------------------------------
------------------------------
------------------------------
------------------------------
------------------------------
--SS----SS--------------------
------------------------------
------------------------------
----------------E-------------
---------------<>---------E---
---------------[]----XXXXXXXXX
---------------[]-------------
------------X--[]-------------
XX--XXXX--XXXXXXXXXXX---------