------------------------------
------------------------------
------------------------------
------------------------------
------------------------------
------E----XX---SQQS--SSSSSSS-
----------XXX-----------------
--------XXXXX-----------------
------EXXXXXX-----------------
-----<>XXXXXX----SS--X--------
-----[]XXXXXX--------X--------
----X[]XXXXXX--------X--------
---XX[]XXXXXX--E-E---X--------
XXXXXXXXXXXXXXXXXXXXXXXX------