------------------------------
------------------------------
------------------------------
------------------------------
------------------------------
--------XX-----SSSSSSSSSS-----
-------XXX--------------------
------XXXX--------------------
-----XXXXX--------------------
-----XXXXX--------------------
---XXXXXXX--------------------
--XXXXXXXX--------------------
-----XXXXX------------------EE
XXXXXXXXXXXX-XXXX---------XXXX