------------------------------
------------------------------
------------------------------
------------------------------
------------------------------
---SSSSS---SSSSSSSSSSSSSSSS---
------------------------------
------------------------------
------------------------------
S-------S------------------S--
------------------------------
------------------------------
------------------------------
XXXXX---XXXXX--------------XXX