-----------------------------
-----------------------------
-----------------------------
-----------------------------
---------------Eoo-----------
--------E------XXXX----------
-------XXXX------------------
-----------------------------
-----------------------XX----
-------------XXXXXXX---------
-----------------------------
---------------------o-------
EE-E----------------XXX------
XXXXX----------------------XX