---------------------------
---------------------------
---------------------------
---------------------------
---------------------------
-------E-------E-----------
------XXXXXX--XXXXXXX------
---------------------------
---------------------------
---------------------------
---------------------------
---------------------------
-EE--------------------XXXX
XXXX-----------------------