-----------------------------
-----------------------------
-----------------------------
-----------------------------
-----------------------------
SSS--SSSSSSSSSSS---SSSSSSSSS-
-----------------------------
-----------------------------
SSS--------------------------
-----------------------------
-----------------------------
-----------------------------
-----------------------------
---XXXX----------XXXX--------