------------------------------
------------------------------
------------------------------
--XX-----XX-------------------
--XX-----XX-------------------
--XX-----XX-------------------
--XX-----XX------------------X
--XX-----XX-----------------XX
--XX-----XX----------------XXX
--XX-----XX---------------XXXX
--XX-----XX--------------XXXXX
--XX-----XX-------------XXXXXX
--XX-----XX------X-----XXXXXXX
XXXXXXXXXXXXXXXXXXXXXXXXXXXXXX