------------------------------
------------------------------
------------------------------
------------------------------
------------------------------
--SS--SSSSS--SS--SSSSSS--S-SS-
------------------------------
------------------------------
------------------------------
------------------------------
------------------------------
------------------------------
------------------------------
XX--XX-----XX--XX------XX-X--X