------------------------------
------------------------------
------------------------------
---------------------XX-------
---------------------XX-------
--SS---SS------------XX------Q
---------------------XX-------
---------------------XX-------
---------------------XX-------
---------------------XX----QQ?
---------------------XX-------
---------------------XX-------
---------------------XX-------
XX--XXX--X--XXXXXXXXXXXXXXXXXX