------------------------------
------------------------------
------------------------------
------------------------------
------------------------------
---SS---SSSSSSSSS--------SSSSS
------------------------------
------------------------------
---SS---SSSSSSSSS-------------
--------------------S-S-------
------------------------------
------------------------------
E----E-----------E-E----------
XX---XX----------XXXXXXXXXX---