------------------------------
------------------------------
------------------------------
------------------------------
-------------------XX---------
------------------------------
-----------------E------------
--------------XXXXX-----------
------------------------------
------------------------------
--XX----XX--XXX--------XXXX--X
------------------------------
------------------------------
X---X-X---X----------------X--