-------------------------
-------------------------
-------------------------
-------------------------
-------------------------
----?--------------------
-------------------------
-------------------------
-----------------S-------
----Q--Q-------------Q---
-------------------------
-------------------------
-------------------------
XXXXXXXXXXXXXXXXXXXXXXXXX