-------------------------
-------------------------
-------------------------
-------------------------
-------------------------
-------------------------
-------------------------
-------------------------
----------------------E--
---------------------<>--
--------E------------[]--
-------<>------------[]--
-------[]------------[]--
----XXXXXXXXXXXXXXXXXXXXX