-----------------------------
-----------------------------
-----------------------------
-----------------------------
-----------------------------
----SSSSSSSS---------XXXX----
--------------------XXXXX----
-------------------XXXXXX----
------------------XXXXXXX----
------------------XXXXXXX----
----------------XXXXXXXXX----
---------------XXXXXXXXXX----
------------------XXXXXXX----
XXXXXX-------XXXXXXXXXXXXXXXX