------------------------------
------------------------------
------------------------------
------------------------------
------------------------------
--SS--SSS---------------------
------------------------------
-----------------oo-----------
------------------------------
-------------XXX------------E-
-------------XXX-------XXXXXX-
-------------XXX--------------
-------------XXX--------------
XX--XX----XXXXX---XXXXX------X