------------------------------
------------------------------
------------------------------
------------------------------
------------------------------
-------E---------S------------
------XXXX--------------------
------------------------------
-------------E--E-EE----------
------------<>------XX-X------
------------[]------XX-X------
------------[]------XX-X------
-EE---------[]------X--X--XXXX
XXXX--------XX------X--X------