------------------------------
------------------------------
------------------------------
------------------------------
------------------------------
------------S-----------------
------------------------------
------------------------------
-oo--------E-EE---------oo---o
-----X--X------XX-X-----------
-----X--X------XX-X-----------
-----X--X------XX-X-----------
-----X--X------X--X-----------
-----X--X------X--X--XX----X--