-----------------------------
-----------------------------
-----------------------------
-----------------------------
-----------------------------
-----------------------------
-----------------------------
-----------------------------
oo---------------------oo---o
-------------------S---------
-----------------------------
-----------------------------
---------EE-EE---------------
-----X--XXXXXXX--XXXXX----X--