------------------------------
------------------------------
----------SSSS----------------
--XX--XX----------X-XX-----X-X
--XX--XX----------X-XX-----X-X
--XX--XX----------X-XX-----X-X
--XX--XX----------X-XX-----X-X
--XX--XX----------X-XX-----X-X
--XX--XX----------X-XX-----X-X
--XX--XX----QQ----X-XX-----X-X
--XX--XX----------X-XX-----X-X
--XX--XX----------X-XX-----X-X
--XX--XX----------X-XX-----X-X
XXXXXXXXXXXXXX--XXXXXXXXXXXXXX