------------------------------
------------------------------
------------------------------
------------------------------
------------------------------
------------XX--------XXX-----
-----------XXX-------XXXX-----
--E-------XXXX------XXXXX-----
-<>------XXXXX-----XXXXXX-----
-[]------XXXXX-----XXXXXX-----
-[]----XXXXXXX---XXXXXXXX-----
-[]---XXXXXXXX--XXXXXXXXX-----
-[]------XXXXX-----XXXXXX-----
-XXXXXXXXXXXXXXXXXXXXXXXXXXXXX