------------------------------
------------------------------
------------------------------
------------------------------
------------------------------
SSSS----------XX-----XX-------
-------------XXX-----XX-------
------------XXXX---XXXX-------
SSSS-------XXXXX---XXXX----E--
-----------XXXXX---XXXX---<>--
---------XXXXXXX--XXXXX---[]--
--------XXXXXXXX--XXXXX---[]--
-----------XXXXX--XXXXX---[]--
----XXXXXXXXXXXXXXXXXXXXXXXXXX