------------------------------
------------------------------
------------------------------
------------------------------
------------------------------
-------E------SSSSSSSS---SSSSS
------XXXX--------------------
------------------------------
------------------------------
------------------------------
------------------------------
------------------------------
-EE---------------------------
XXXX--------XXXX-------XXXX---