------------------------------
------------------------------
------------------------------
------------------------------
------------------------------
SSSS-----------XX--------XXX--
--------------XXX-------XXXX--
-------------XXXX------XXXXX--
SSSS--S-----XXXXX-----XXXXXX--
------------XXXXX-----XXXXXX--
----------XXXXXXX---XXXXXXXX--
---------XXXXXXXX--XXXXXXXXX--
------------XXXXX-----XXXXXX--
----XXXXXXXXXXXXXXXXXXXXXXXXXX