------------------------------
------------------------------
------------------------------
------------------------------
------------------------------
-------------XX--------XXX----
------------XXX-------XXXX----
-----------XXXX------XXXXX----
----------XXXXX-----XXXXXX--o-
----------XXXXX-----XXXXXX----
--------XXXXXXX---XXXXXXXX----
-------XXXXXXXX--XXXXXXXXX----
--XX------XXXXX-----XXXXXX----
XXXXXXXXXXXXXXXXXXXXXXXXXXXXXX