------------------------------
------------------------------
------------------------------
------------------------------
-oo---------------------------
-----SSSSSSS-----E-----------S
----------------XXXXX----E----
------------------------<>----
------------------------[]----
------------------------XXX---
------------------------------
------------------------------
-EE---------------------------
XXXXXXX------X---------XXXXXXX