------------------------------
------------------------------
------------------------------
------------------------------
------------------------------
---SSSSS---SSSSSSSSSSSS---SSSS
------------------------------
------------------------------
------------------------------
S-------S--------------S------
------------------------------
------------------------------
------------------------------
XXXXX---XXXXX----------XXXXX--