-------------------------
-------------------------
-------------------------
-------------------------
-------------------------
----------------------XXX
---------------------XXXX
--------------------XXXXX
-------------------XXXXXX
------------------XXXXXXX
-----------------XXXXXXXX
-------------<>-XXXXXXXXX
--E-EE-E-----[]XXXXXXXXXX
XXXXXXXXXXXXXXXXXXXXXXXXX