------------------------------
------------------------------
------------------------------
------------------------------
------------------------------
---SSS---SSSS--------SSSS---SS
------------------------------
------------------------------
---SSS---SSSS--------SSSS---SS
------------------------------
------------------------------
------------------------------
E-----E------------------E----
XX----XX-----XXXXXXX-----XX---