----------------------------
----------------------------
----------------------------
----------------------------
----------------------------
----------------------------
----------------------------
----------------------------
-o---oo---------------------
----------------------------
----------------------------
----------------------------
-----------XX---EE-E--------
---X----X------XXXXXXXXXXXXX