------------------------------
------------------------------
------------------------------
------------------------------
---o------o-------------------
------------------------------
------------------------------
-------------------------X-X-X
---------------oo-------------
------------------------------
-------------------E---XXXXXXX
------------------------------
------------------------------
X---X-XX---X-X----X-XXX-------