------------------------------
------------------------------
------------------------------
------------------------------
------------------------------
---SSSS---SSSSS------XX--S-SSS
---------------------XX-------
-------------------XXXX-------
-------------------XXXX-------
S------S-----------XXXX-------
------------------XXXXX-------
------------------XXXXX-------
------------------XXXXX-------
XXXXX--XXXXX----XXXXXXXXXXXXX-