------------------------------
------------------------------
------------------------------
------------------------------
------------------------------
------E-------------XXXX------
-------------------XXXXX------
-XXX--------------XXXXXX------
-----------------XXXXXXX--?---
--------XX-------XXXXXXX------
---------------XXXXXXXXX------
--------------XXXXXXXXXX------
-----ooo---------XXXXXXX------
-----XXX----XXXXXXXXXXXXXXXXXX