------------------------------
------------------------------
------------------------------
------------------------------
------------------------------
------------------------------
------------------------------
------------------------------
------------------------------
------------------------------
------------------------------
------------------------------
-EE-----------XXXXX--XXX--XX--
XXXXXXXXXXXX------------------