-------------------------
-------------------------
-------------?-----------
-------------------------
-------------------------
-------------------------
---------------SS--------
--------------------XSS--
--S--------SS------XXX---
------------------XXXX-SS
-----------------XXXXX---
----------------XXXXXX--S
---------------XXXXXXX---
XXXXXXX-XXXXXX-XXXXXX----