------------------------------
------------------------------
------------------------------
------------------------------
------------------------------
--------XXX----SSSSSSSSSS-----
-------XXXX-------------------
------XXXXX-------------------
-----XXXXXX-------------------
-----XXXXXX-------------------
---XXXXXXXX-------------------
--XXXXXXXXX-------------------
-----XXXXXX-----------------EE
XXXXXXXXXXXXXXXXX---------XXXX