------------------------------
------------------------------
------------------------------
------------------------------
------------------------------
-------E---------E------------
------XXXXX-----XXXXXXXXX-----
------------------------------
------------------------------
------------------------------
------------------------------
------------------------------
----------------------------EE
XXXX---------X-------------XXX