-------------------------
-------------------------
-------------------------
-------------------------
-------------------------
-----------S-------------
-------------------------
-------------------------
oo-----o--E-EE-------oo--
----X---------XX-X-------
----X---------XX-X-------
----X---------XX-X-------
----X---------X--X-------
----X---------X--X-------