------------------------------
------------------------------
------------------------------
------------------------------
------------------------------
-----SSSSSSSSS-----SSSSSSSSS--
------------------------------
------------------------------
------------------------------
------------------------------
------------------------------
------------------------------
-E--------------E-------------
XXXXXXX--------XXXXXX--------X