------------------------------
------------------------------
------------------------------
--XX--X----XX--X-------XX--X--
--XX--X----XX--X-------XX--X--
--XX--X----XX--X-------XX--X--
--XX--X----XX--X-------XX--X--
--XX--X----XX--X-------XX--X--
--XX--X----XX--X-------XX--X--
--XX--X----XX--X-------XX--X--
--XX--X----XX--X-------XX--X--
--XX--X----XX--X-------XX--X--
--XX--X----XX--X--E----XX--X--
XXXXXXXXXXXXXXXXXXXXXXXXXXXXXX