------------------------------
------------------------------
------------------------------
------------------------------
------------------------------
-SSSS----SSSSSSSSSSSSS--------
----------------------------E-
---------------------------<>-
--E------------------------[]-
SSSSS----------------------XX-
------------------------------
------------------------------
------------------------------
XXXXXXXXXXX------------XXXXXXX