------------------------------
------------------------------
------------------------------
------------------------------
-----------------oo----oo----E
--------S--------------------E
------------------------------
------------------------------
---E---E-EE-------------------
--<>-------XX-X---XXX---XXXX--
--[]-------XX-X---------------
--[]-------XX-X---------------
--[]-------X--X---------------
--XX-------X--X---------------