-----------------------------
-----------------------------
-----------------------------
-----------------------------
-----------------------------
SSSS-----------------XXXX----
--------------------XXXXX----
------------X------XXXXXX----
SSSS-------XX-----XXXXXXX--?-
-----------XX-----XXXXXXX----
---------XXXX---XXXXXXXXX----
--------XXXXX--XXXXXXXXXX----
-----------XX-----XXXXXXX----
----XXXXXXXXXXXXXXXXXXXXXXXXX