------------------------------
------------------------------
------------------------------
--XX-------XX-----------XX----
--XX-------XX-----------XX----
--XX-------XX-----SS----XX----
--XX-------XX-----------XX----
--XX-------XX-----------XX----
--XX-------XX-----------XX----
--XX-------XX-----------XX----
--XX-------XX-----------XX----
--XX-------XX-----------XX----
--XX-------XX-----------XX----
XXXXXXXXXXXXXXXXXX--XXXXXXXXXX