------------------------------
------------------------------
------------------------------
------------------------------
------------------------------
---SSS---SSSSSSSSSS---SSS---SS
------------------------------
------------------------------
------------------------------
S-----S------------S-----S----
------------------------------
------------------------------
------------------------------
XXXXX-XXXXX--------XXXXX-XXXXX