-------------------------
-------------------------
-------------------------
-------------------------
----E--------------------
--SSSSSSS----------------
-------------------------
-------------------------
-------------------------
-------------------S--Q--
-------------------------
-------------------------
--------------EE------E--
XXXXXXX---XXXXXXXXXXXXXXX