------------------------------
------------------------------
------------------------------
------------------------------
------------------------------
SS--SSSSSSSS---SSSSSSSSS------
------------------------------
-----------------------------<
SS---------------------------[
-----------------------------X
------------------------------
------------------------------
------------------------------
--XXXXX------XXXX--------XXXXX