----------------------------
----------------------------
----------------------------
----------------------------
----------------------------
-------E-----E--------------
------XXXX--XXXX------------
----------------------------
----------------------------
----------------------------
----------------------------
----------------------------
E-E---------------XXXXX--XXX
XXXX------------------------