------------------------------
------------------------------
------------------------------
------------------------------
------------------------------
----SSSSSSSS---SSSSSSSSS------
------------------------------
-----------------------------<
-----------------------------[
-----------------------------X
------------------------------
------------------------------
------------------------------
XXXXXXX------XXXX--------XXXXX