------------------------------
------------------------------
------------------------------
------------------------------
------------------------------
-------XX--SSSSSSSSSS---------
-------XX---------------------
-----XXXX---------------------
-----XXXX---------------------
-----XXXX---------------------
----XXXXX---------------------
----XXXXX---------------------
----XXXXX---------------EE-EE-
X-XXXXXXXXXXX---------XXXXXXXX