------------------------------
------------------------------
------------------------------
--XX--X--XX--XX---------------
--XX--X--XX--XX---------------
--XX--X--XX--XX---------------
--XX--X--XX--XX---------XXX--o
--XX--X--XX--XX-------------XX
--XX--X--XX--XX---------------
--XX--X--XX--XX---------------
--XX--X--XX--XX-------XXX-----
--XX--X--XX--XX---------------
--XX--X--XX--XX---------------
XXXXXXXXXXXXXXXXX-X-X-------XX