------------------------------
------------------------------
------------------------------
--XX----XX-------XX-X---------
--XX----XX-------XX-X---------
--XX----XX---SS--XX-X---------
--XX----XX-------XX-X---------
--XX----XX-------XX-X---------
--XX----XX-------XX-X---------
--XX----XX-------XX-X---------
--XX----XX-------XX-X---------
--XX----XX-------XX-X---------
--XX----XX-------XX-X---E-E-E-
XXXXXXXXXXXXX--XXXXXXXXXXXXXXX