-------------------------
-------------------------
-------------------------
-------------------------
-------------------------
-------------------------
-------------------------
--------------------X----
------X------------XX----
-----XX------------XX----
----XXX----------XXXX----
---XXXX---------XXXXX----
--XXXXX--X---------XX----
XXXXXXXXXXXXXXXXXXXXXXXXX