------------------------------
------------------------------
------------------------------
------------------------------
------------------------------
----SSSSSSS----------------XXX
--------------------------XXXX
------------------X------XXXXX
-----------------XX-----XXXXXX
-E-X-------------XX-----XXXXXX
<>-X-----------XXXX---XXXXXXXX
[]-X----------XXXXX--XXXXXXXXX
[]-X-------------XX-----XXXXXX
XXXXXXX-----XXXXXXXXXXXXXXXXXX