------------------------------
------------------------------
------------------------------
------------------------------
-------------------------oo---
-------------------------XX---
------------------------------
------------------------------
------------------------------
--------E--------EE-----------
--XX--XXX--XX--XXXXXXXXX?-----
------------------------------
------------------------------
X---X----X---X----------XXX-X-