-----------------------------
-----------------------------
-------------oo--------------
-----------------E--E--------
----------------XXXXXXX------
---------oo------------------
-----------------------------
-----------------------------
----------XXXXXX-------------
-----------------------------
----------------------------X
---------------------------XX
--XXXXX----------------------
-------------------------XXXX