------------------------------
------------------------------
------------------------------
------------------------------
------------------------------
-------E---------------SSSSSSS
------XXXXXXXXXX--------------
------------------------------
------------------------------
------------------------------
------------------------------
------------------------------
-------------------EE---------
XXXX--------------XXXXXXX-----