------------------------------
------------------------------
------------------------------
------------------------------
------------------------------
--S-----------------SSSSSSSSSS
------------------------------
------------------------------
-E-EEE------------------------
------XX-X--------------------
------XX-X--------------------
------XX-X--------------------
------X--X---EE-EE------------
------X--X--XXXXXXXXXX--------