------------------------------
------------------------------
------------------------------
------------------------------
------------------------------
-------------XX--SSSSSSSS---SS
------------XXX---------------
-----------XXXX---------------
----------XXXXX---------------
---------XXXXXX----------S----
--------XXXXXXX---------------
---X---XXXXXXXX---------------
--XX--XXXXXXXXX---------------
XXXXXXXXXXXXXXXXXXX-X-X--XXXXX