------------------------------
------------------------------
------------------------------
------------------------------
------------------------------
------SSSSSSS----------XX-----
----------------------XXX-----
---------------------XXXX-----
----SS--------------XXXXX-----
-------------------XXXXXX-----
------------------XXXXXXX---XX
-----------------XXXXXXXX--XXX
E---------------XXXXXXXXX-----
XXXXXXX-------XXXXXXXXXXXXXXXX