------------------------------
------------------------------
------------------------------
------------------------------
------------------------------
---SS------SS---------------E-
-------------------E--E-------
-----------------XXXXXXXXX----
---SS------SS-----------------
------------------------------
------------------------------
------------------------------
E----E--E----E-------------ooo
XX---XX-XX---XX------------XXX