------------------------------
------------------------------
------------------------------
------------------------------
------------------------------
---------SSSSSSSSSSSSS--------
----E-----------------------E-
---<>----------------------<>-
---[]----------------------[]-
---XX----------------------XX-
------------------------------
------B-----------------------
------b-----------------------
--XXXXXXXXX------------XXXXXXX