------------------------------
------------------------------
------------------------------
------------------------------
------------------------------
--S---------S--------------S--
------------------------------
------------------------------
-E-EE------E-EE-------oo--E-EE
-----XX-X------XX-X-----------
-----XX-X------XX-X-----------
-----XX-X------XX-X-----------
-----X--X------X--X-----------
-----X--X------X--X-----------