-------------------------
-------------------------
-------------------------
-------------------------
-------------------------
-------------oo----------
-------------------------
-------------------------
-------oo----------oo----
-----------XX--XX------XX
-------------------------
-------------------------
EE-E---------------------
XXXXX--------------------