------------------------------
------------------------------
------------------------------
------------------------------
------------------------------
---SS---SSSS-------SSSSSSSSS--
------------------------------
------------------------------
---SS---SSSS------------------
----------------------------S-
------------------------------
------------------------------
E----E------------------------
XX---XX-----XXXXXXXXX-------XX