------------------------------
------------------------------
------------------------------
------------------------------
------------------------------
-----X-----XXXXX----XXXX-----X
------------------------------
------------------------------
----------------XX------------
------------------------------
------------------------------
------------------------------
------------------------------
XXX---XXX---------------XXX---