-------------------------
-------------------------
-------------------------
-------------------------
-------------------------
-------------------------
-------------------------
-------------------------
--------------------o----
-------------------------
-------------------------
-------------------------
-EE------XXXXX--XX-----XX
XXXXXXX------------------