------------------------------
------------------------------
------------------------------
------------------------------
------------------------------
SS------SSSSS----------XXX----
----------------------XXXX----
---------------------XXXXX----
SS----SS------------XXXXXX----
-------------------XXXXXXX----
------------------XXXXXXXX----
-----------------XXXXXXXXX----
----------------XXXXXXXXXX----
--XXXXXXX-----XXXXXXXXXXXXXXXX