------------------------------
------------------------------
------------------------------
------------------------------
------------------E-----------
------S-----------E--E-----S--
--------------------XXXX------
------------------------------
-oo--E-EE-----------------E-EE
---------XX-X--XX-------------
---------XX-X-----------------
---------XX-X-----------------
---------X--X-----------------
---------X--X-----------------