------------------------------
------------------------------
-------------oo---------------
-----------------E--E---------
----------------XXXXXXX-------
---------oo-------------------
------------------------------
------------------------------
----------XXXXXX--------------
------------------------------
----------------------------XX
---------------------------XXX
-XXXXXX-----------------------
-------------------------XXXXX