-------------------------
-------------------------
-------------------------
-------------------------
-------------------------
------------E------------
-----------<>------------
-----E-----[]------------
-o--<>-----XXX------SSSSS
----[]-----------E-------
----[]---------E<>-------
----[]--------<>[]-------
----[]--------[][]-------
----XXXXXXXXXXXXXXXXXXXXX