------------------------------
------------------------------
------------------------------
------------------------------
------------------------------
--------SSSSSSSSSSSSSSSSS-----
------------------------------
------------------------------
------------------------------
------------------------------
------------------------------
------------------------------
-E-E-E----------------------EE
XXXXXXXXXXX---------------XXXX