------------------------------
------------------------------
------------------------------
------------------------------
------------------------------
----------S-------------------
------------------------------
---X--------------------------
---X----EE-EE-------------oo--
-X-X---------XX-X-----E-------
-X-X---------XX-X----<>-------
-X-X---------XX-X----[]-------
-X-X---------X--X----[]-------
-X-X---------X--X----XX-------