------------------------------
------------------------------
------------------------------
------------------------------
------------------------------
--SS--SSSSSSSSSSSS-S--S---S-SS
------------------------------
------------------------------
------------------------------
------------------------------
------------------------------
------------------------------
------------------------------
XX--XX------------X-XX-XXX-X--