-----------------------------
-----------------------------
-----------------------------
-----------------------------
-----------------------------
--------XXX--------XX---SSSSS
--------XXX-------XXX--------
------XXXXX------XXXX--------
------XXXXX-----XXXXX--------
------XXXXX-----XXXXX--------
-----XXXXXX---XXXXXXX--------
-----XXXXXX--XXXXXXXX--------
-----XXXXXX-----XXXXX--------
XXXXXXXXXXXXXXXXXXXXXXXXXX---