------------------------------
------------------------------
------------------------------
------------------------------
------------------------------
--S--------------SSSSSS-----S-
------------------------------
------------------------------
-E-EE----------------------E-E
-----XX--X--------------------
-----XX--X--------------------
-----XX--X--------------------
-----X---X---EE---------------
-----X---X--XXXXXXX-----X-----