------------------------------
------------------------------
------------------------------
------------------------------
------------------------------
SSS--SSSSSSSS-----S---------S-
------------------------------
------------------------------
SSS--------------E-EE------E-E
---------------------XX-X-----
---------------------XX-X-----
---------------------XX-X-----
---------------------X--X-----
---XXXXX------X------X--X-----