------------------------------
------------------------------
------------------------------
------------------------------
------------------------------
---SSSS---SSSSSSSSSSSSSSS---SS
------------------------------
------------------------------
------------------------------
S------S-----------------S----
------------------------------
------------------------------
------------------------------
XXXXX--XXXXX-------------XXXXX