------------------------------
------------------------------
------------------------------
------------------------------
------------------------------
-------SSSSS---------XXXX-----
--------------------XXXXX-----
-------------------XXXXXX-----
--E--SS-----------XXXXXXX-----
-<>---------------XXXXXXX-----
-[]-------------XXXXXXXXX-----
-[]------------XXXXXXXXXX----<
-[]---------------XXXXXXX----[
-XXXXXXX-----XXXXXXXXXXXXXXXXX