------------------------------
------------------------------
------------------------------
------------------------------
------------------------------
---SSS---SSS---SSS---SSS-----S
------------------------------
------------------------------
---SSS---SSS---SSS---SSS------
------------------------------
------------------------------
------------------------------
E-----E-----E-----E-----------
XX----XX----XX----XX----XX-XX-