------------------------------
------------------------------
------------------------------
------------------------------
------------------------------
--S--------------S---------S--
------------------------------
------------------------------
-E-EE-----------E-EE------E-EE
-----XX-X-----------XX-X------
-----XX-X-----------XX-X------
-----XX-X-----------XX-X------
-----X--X---E-------X--X------
-----X--X--XXX------X--X------