------------------------------
------------------------------
------------------------------
------------------------------
------------------------------
--S----------S--------SSSSSSSS
------------------------------
------------------------------
-E-EEE------E-EE--------------
------XX-X------XX------------
------XX-X------XX------------
------XX-X------XX------------
------X--X------X-------------
------X--X------X---XXXX------