------------------------------
------------------------------
------------------------------
------------------------------
------------------------------
SSSS--SSSSSS---SSSSSSS-----S--
------------------------------
------------------------------
SSSS----------------------E-EE
------------------------------
------------------------------
------------------------------
------------------------------
----XXXX-----XXXX------X------