-------------------------
-------------------------
-------------------------
-------------------------
-------------------------
-------------------------
-------------------------
----------X--------------
---------XX--------------
--------XXX--------E-----
-------XXXX-------<>-----
------XXXXX-------[]-----
-----XXXXXX-------[]-----
XXXXXXXXXXXXXXX--XXXXXXXX