------------------------------
------------------------------
------------------------------
------------------------------
------------------------------
SSS---------XX--SSSSSSSSSSSS--
-----------XXX----------------
----------XXXX----------------
SSS------XXXXX----------------
--------XXXXXX----------------
-------XXXXXXX----------------
------XXXXXXXX----------------
-----XXXXXXXXX----------------
---XXXXXXXXXXXXXXXXXXXX------X