------------------------------
------------------------------
------------------------------
------------------------------
------------------------------
---SSSSS------SSSSS------XXX--
-------------------------XXX--
-----------------------XXXXX--
-----------------------XXXXX--
S-------S--S-------S---XXXXX--
----------------------XXXXXX--
----------------------XXXXXX--
----------------------XXXXXX--
XXXXX---XXXXXXXX---XXXXXXXXXXX