------------------------------
------------------------------
------------------------------
------------------------------
------------------------------
--S--------S-----------S------
------------------------------
------------------------------
-E-EE----EE-EEEE------E-EE----
-----XX---------XX-X------XXX-
-----XX---------XX-X------XXX-
-----XX---------XX-X------XXX-
-----X----------X--X------X---
-----X----------X--X------X---