------------------------------
------------------------------
------------------------------
------------------------------
------------------------------
-------E-----------E----------
------XXXXX-------XXXXXX------
------------------------------
------------------------------
------------------------------
------------------------------
------------------------------
-EE-----------E------------EE-
XXXX---------XXX----------XXXX