------------------------------
------------------------------
------------------------------
------------------------------
------------------------------
-----------------------S------
------------------------------
------------------------------
----------------------E-EEEEEE
------------------------------
------------------------------
------------------------------
---XX---XXXXXXX---------------
X----X-----------XXX----------