------------------------------
------------------------------
------------------------------
------------------------------
------------------------------
--S--------SSSSSSSSSSSS-------
-----------------------------E
----------------------------<>
-E-EE-----------------------[]
-----XX---------------------XX
-----XX-----------------------
-----XX-----------------------
-----X------------------------
-----X---XXXX-X---------XXXXXX