------------------------------
------------------------------
------------------------------
------------------------------
--------oo-----------E--------
---------------------E--E-----
-----------------------XXXX---
------------------------------
-----------------------------E
------XX------XX--XX----------
------------------------------
---------XXX------------------
-EE---------------------------
XXXX--------------------------