------------------------------
------------------------------
---------------oo-------------
-------------------E--E-------
------------------XXXXXXX-----
-----------oo-----------------
------------------------------
------------------------------
------------XXXXXX------------
------------------------------
------------------------------
------------------------------
-XXXXXXXX------------------XXX
------------------------------