------------------------------
------------------------------
------------------------------
--XX--XX--XX--XX-------X-XX---
--XX--XX--XX--XX-------X-XX---
--XX--XX--XX--XX--SS---X-XX---
--XX--XX--XX--XX-------X-XX---
--XX--XX--XX--XX-------X-XX---
--XX--XX--XX--XX-------X-XX---
--XX--XX--XX--XX-------X-XX---
--XX--XX--XX--XX-------X-XX---
--XX--XX--XX--XX-------X-XX---
--XX--XX--XX--XX-------X-XX---
XXXXXXXXXXXXXXXXXX---XXXXXXXX-