------------------------------
------------------------------
------------------------------
------------------------------
----------------------Eoo-----
-------E--------------XXXX----
------XXXXXXXXXX--------------
------------------------------
------------------------------
--------------------XXXXXXX---
------------------------------
----------------------------o-
-EE------------------------XXX
XXXX--------------XX----------