------------------------------
------------------------------
------------------------------
------------------------------
------------------------------
----SSSSSSS---------XXXX--?---
-------------------XXXXX------
------------------XXXXXX------
-----------------XXXXXXX------
-----------------XXXXXXX--Q---
---------------XXXXXXXXX------
--------------XXXXXXXXXX------
-----------------XXXXXXX------
XXXXXX------XXXXXXXXXXXXXXXXXX