------------------------------
------------------------------
------------------------------
------------------------------
------------------------------
--S---------SSSSSSSSSSSSS-----
------------------------------
------------------------------
-E-EEE------------------------
------XX----------------------
------XX----------------------
------XX----------------------
------X-----------------------
------X---XXXX------------XXXX