------------------------------
------------------------------
------------------------------
------------------------------
------------------------------
--SS---SS---------SS-S--------
------------------------------
------------------------------
------------------------------
-------------E---------------<
------------<>---------------[
------------[]---------------[
------------[]---------------[
XX--XXX--X--XX--XX--X-XXXXXXXX