------------------------------
------------------------------
------------------------------
------------------------------
------------------------------
---SSSS---SSSSSSSSSSSSS-------
------------------------------
------------------------------
------------------------------
S------S----------------------
------------------------------
------------------------------
---------------------------XX-
XXXXX--XXXXX------------X-----