------------------------------
------------------------------
------------------------------
------------------------------
------------------------------
SSS---SSSSSSS---SSSSSSS-----S-
------------------------------
------------------------------
SSS------------------------E-E
------------------------------
------------------------------
------------------------------
------------------------------
---XXXXX------XXXX------X-----