------------------------------
------------------------------
------------------------------
------------------------------
------------------------------
----SSSSSSSSSS---------XXX----
----------------------XXXX----
---------------------XXXXX----
--------------------XXXXXX----
--------------------XXXXXX----
------------------XXXXXXXX----
-----------------XXXXXXXXX----
--------------------XXXXXX----
-XXXXX---------XXXXXXXXXXXXXXX