------------------------------
------------------------------
------------------------------
------------------------------
------------------------------
--------SSSSSSSSSSSSSSS-------
-----------------------------E
--E-------------------------<>
-<>-------------------------[]
-[]-------------------------XX
-[]---------------------------
-[]---------------------------
-[]---------------------------
-XXXXXXXXX--------------XXXXXX