-----------------------------
-----------------------------
-----------------------------
-----------------------------
-------oo--------------------
------------------oo---------
-----------------------------
-----------------------------
-----------------------------
--E-----XXX--X--XX--XXX---XXX
-<>----------X------------XXX
-[]----------X------------XXX
-[]----------X------------XXX
-XX----------X------------XX-