------------------------------
------------------------------
------------------------------
------------------------------
------------------------------
---------------S--------------
------------------------------
------------------------------
-oo-----o--o--E-EE-------oo--E
-----X------------XX-X--------
-----X------------XX-X--------
-----X------------XX-X--------
-----X------------X--X--------
-----X------------X--X--------