------------------------------
------------------------------
------------------------------
------------------------------
------------------------------
SSSS-----------XX--SSSSSSSSSSS
--------------XXX-------------
-------------XXXX-------------
SSSS--------XXXXX-------------
------------XXXXX-------------
----------XXXXXXX-------------
---------XXXXXXXX-------------
------------XXXXX-------------
----XXXXXXXXXXXXXXXXXXXXXX----