------------------------------
------------------------------
------------------------------
------------------------------
------------------------------
--SS--SSSSSS--SS--SSSSSSSSSSS-
------------------------------
------------------------------
------------------------------
------------------------------
------------------------------
------------------------------
------------------------------
XX--XX------XX--XX-----------X