------------------------------
------------------------------
------------------------------
--XX---XX---------------------
--XX---XX---------------------
--XX---XX---------------------
--XX---XX---------------------
--XX---XX---------------------
--XX---XX---------------------
--XX---XX-----X---------------
--XX---XX----XXX------X--X--XX
--XX---XX---XXXX--------------
--XX---XX--XXXX---------------
XXXXXXXXXXXXXXX---X-X--X--X---