------------------------------
------------------------------
------------------------------
--XX-----XX-------------------
--XX-----XX-------------------
--XX-----XX--------S-S-S--SS--
--XX-----XX-------------------
--XX-----XX-------------------
--XX-----XX-------------------
--XX-----XX-------------------
--XX-----XX-------------------
--XX-----XX---E---------------
--XX-----XX-------------------
XXXXXXXXXXXXXXXX-XX-X-X-XX--XX