------------------------------
------------------------------
------------------------------
------------------------------
------------------------------
---------E------E-----E-------
--------XXXXX--XXXX--XXXX-----
------------------------------
------------------------------
------------------------------
------------------------------
------------------------------
EE-EE----------------------XXX
XXXXXX------------------------