--------------------------
--------------------------
--------------------------
--------------------------
--------------------------
--------------------------
---------E--E----E--------
-----XXXXXXXXXXXXXXXXXXXX-
-oo-----------------------
--------------------------
--------------------------
--------------------------
--------------------------
--------------------------