------------------------------
------------------------------
------------------------------
------------------------------
------------------------------
-------------E----------------
------------XXXXXXXXXXX-------
------------------------------
------------------------------
-------------------------SS-S-
------------------------------
------------------------------
---X---XXX--------------------
X---X--------------------XXXXX