------------------------------
------------------------------
------------------------------
------------------------------
------------------------------
------------------------S-S---
------------------------------
------------------------------
------------------------S-S---
------------------------------
------------------------------
---B------B-------B-----------
E--bE-EE--bE-E----bE-E-----E--
XXXXXXXXXXXXXXXXXXXXXXX----XX-