-------------------------
-------------------------
-------------------------
-------------------------
-------------------------
--S----------XXX---------
-------------XXX---------
-----------X-XXX---------
-E-EE------X-XXX-------XS
-----XX-XX-X-XXX------XXX
-----XX-XX-X-XXX-----XXXX
-----XX-XX-X-XXX----XXXXX
-----X--XX-X-XXX---XXXXXX
-----X--XX-X-XXXXXXXXXXX-