-----------------------------
-----------------------------
-----------------------------
-----------------------------
---------------------------Eo
-------E------E-----E------XX
------XXXXX--XXXX--XXXX------
-----------------------------
-----------------------------
-------------------------XXXX
-----------------------------
-----------------------------
-EE--------------------------
XXXX-------------------------