------------------------------
------------------------------
------------------------------
------------------------------
------------------------------
---------E-----E-----------SSS
--------XXXX--XXXXXX----------
------------------------------
------------------------------
------------------------------
------------------------------
------------------------------
E-E--------------------EE-----
XXXXXX----------------XXXXXXX-