------------------------------
------------------------------
------------------------------
------------------------------
------------------------------
--SS---SS-----SS---SS---------
------------------------------
-----------------------------X
----------------------------XX
----------------------------XX
--------------------------XXXX
-------------------------XXXXX
----------------------------XX
XX--XXX--XXXXX--XXX--XXXXXXXXX