------------------------------
------------------------------
------------------------------
------------------------------
------------------------------
--SS---SS----------------SS---
----------------------o-------
------------------------------
------------------------------
------------------------------
------------------------------
------------------------------
--------------E------XX-------
XX--XXX--X--XXXXXXX----XX--XXX