------------------------------
------------------------------
------------------------------
------------------------------
------------------------------
--SS---SS-------SS-S----------
------------------------------
------------------------------
------------------------------
------------------------------
------------------------------
------------------------------
----------------------------E-
XX--XXX--X--XXXX--X-XXXX----XX