------------------------------
------------------------------
------------------------------
------------------------------
------------------------------
-------E----------E-----------
------XXXXXXXXX--XXXX----E--E-
-----------------------XXXXXXX
------------------------------
------------------------------
------------------------------
------------------------------
E-E---------------------------
XXXX--------------------------