------------------------------
------------------------------
------------------------------
------------------------------
------------------------------
----SSSSSSSSSSS---SSSSSSSS----
------------------------------
------------------------------
------------------------------
------------------------------
------------------------------
------------------------------
------------------------------
XXXXXX----------XXXX-------XXX