------------------------------
------------------------------
------------------------------
------------------------------
------------------------------
SS-------SSSSSSS---SSSS----S--
------------------------------
------------------------------
SS---------------------EEEE-EE
------------------------------
------------------------------
------------------------------
----EEE-----------------------
--XXXXXXXXX------XXXX---------