-------------------------
-------------------------
-------------------------
-------------------------
-------------------------
-------------------------
-------------------------
-------------------------
-------------------------
------S---------X-----X--
---------------XX----XX--
-----------<>-XXX---XXX--
-----------[]XXXX--XXXX--
XXXXXXXXXXXXXXXXXXXXXXXXX