-------------------------
-------------------------
-------------------------
-------------------------
-------------------------
----------SSSSS----------
-------------------------
---------E---------------
-------------------------
-------S?S--------------<
------------------------[
------------------------[
---------------EE-EE-EE-[
XX--XXXXXXXXXXXXXXXXXXXXX