-------------------------
-------------------------
-------------------------
-------------------------
---------------------oo--
----------------S--------
-------------------------
-------------------------
-------------------------
------Q--QQQ----S--------
---E---------------------
---------E---------------
------------------EE-EE--
-XXXXXXXXXXXXXXXXXXXXXXXX