------------------------------
------------------------------
------------------------------
------------------------------
----------------------------XX
------------------------------
--------------------------E---
-----------------------XXXXX--
------------------------------
--------E--------E------------
--XX--XXX--XX--XXXXXXXXX------
------------------------------
------------------------------
X---X----X---X----------------