-----------------------------
-----------------------------
-----------------------------
-----------------------------
-----------------------------
SSSS-------SSS---SSSSSSSSSSSS
-----------------------------
-----------------------------
SSSS----SSS------------------
-----------------------------
-----------------------------
-----------------------------
-----------------------------
----XXXXXXXX---XXXXXXXXX-----