------------------------------
------------------------------
------------------------------
------------------------------
---o---oo---o---oo----------oo
--------------------oo--------
------------------------------
------------------------------
------------------------------
--------X--------XXX--XX-----X
------------------------------
------------------------------
------------------------------
X---X----X---X----------------