------------------------------
------------------------------
------------------------------
--XX-------XX-----------------
--XX-------XX-----------------
--XX-------XX-----------------
--XX-------XX-----------------
--XX-------XX-----------------
--XX-------XX-----------------
--XX-------XX--------XX-------
--XX-------XX-----B-----------
--XX-------XX-----b-----------
--XX-------XX-----------------
XXXXXXXXXXXXXXXXXXXXX----XXXXX