-----------------------------
-----------------------------
-----------------------------
-----------------------------
-----------------------------
-----------------------------
------E--E--E--E----E--------
----XXXXXXXXXXXXXXXXXXXXXXXX-
-----------------------------
-X---------------------------
-X---------------------------
-X---------------------------
-X---------------------------
-X---------------------------