------------------------------
------------------------------
------------------------------
------------------------------
------------------------------
--S-----------SSSSSS---SSSS---
------------------------------
------------------------------
-E-EEE---------------------EEE
------XX-X--------------------
------XX-X--------------------
------XX-X--------------------
------X-----------------------
------X-----XXXX-----XXXX-----