-------------------------
-------------------------
-------------------------
-------------------------
-------------------------
-------------------------
-------------------------
-------------------------
----------S--------------
--------------X----------
--------------XX---------
--------------XXX--------
---E----------XXXX-------
XXXXXXXXXXXXXXXXXXXXXXXXX