------------------------------
------------------------------
------------------------------
------------------------------
------------------------------
SSSSSS----------S----------S--
------------------------------
------------------------------
SSSSSS---------E-EE-------E-EE
-------------------XX-X-------
-------------------XX-X-------
-------------------XX-X-------
--------EE---------X--X-------
------XXXXX-X------X--X-------