------------------------------
------------------------------
------------------------------
-----------------------------X
-----------------------------X
--SS--S----SS--S-------SS-S--X
-----------------------------X
-----------------------------X
-----------------------------X
-----------------------------X
-----------------------------X
-----------------------------X
-----------------------------X
XX--XX-XXXX--XX-XXXXXXX--X-XXX