------------------------------
------------------------------
------------------------------
------------------------------
------------------------------
----SSSSSSSSSSSS---------XX---
------------------------XXX---
-----------------------XXXX---
----------------------XXXXX--S
----------------------XXXXX---
--------------------XXXXXXX---
-------------------XXXXXXXX---
----------------------XXXXX---
XXXXXX-----------XXXXXXXXXXXXX