------------------------------
------------------------------
------------------------------
------------------------------
------------------------------
----SSSSSSSSSSSSS---SSSSSSSSSS
------------------------------
------------------------------
------------------------------
------------------------------
------------------------------
------------------------------
------------------------------
XXXXXX------------XXXXXXXXX---