----------------------------
----------------------------
----------------------------
----------------------------
----------------------------
----------------------------
------E--E----E----E--------
----XXXXXXXXXXXXXXXXXXXXXXX-
----------------------------
----------------------------
----------------------------
----------------------------
----------------------------
----------------------------