-------------------------
-------------------------
-------------------------
-------------------------
-------------------------
-------------------------
-------------------------
-------------------------
-------------------------
--X------------SSS-------
--XX---------------------
X-XXX--------------B-----
X-XXXX-------------b-----
X-XXXXXXXXXXXXXXXXXXXXXXX