-------------------------
-------------------------
-------------------------
-------------------------
-------------------------
-------------------------
-------------------------
-------------------------
---------------S---------
-------------------------
-------------------------
----------<>-------------
----------[]-------------
XXXXXXXXXXXXXXXXXX--XXXXX