------------------------------
------------------------------
------------------------------
-------------------XXXX-X----X
-------------------XXXX-X----X
-------------------XXXX-X----X
-------------------XXXX-X----X
-------------------XXXX-X----X
-------------------XXXX-X----X
-------------------XXXX-X----X
-------------------XXXX-X----X
----------------X--XXXX-X----X
----------------X--XXXX-X----X
XXXXXXXXXXXXXXXXXXXXXXXXXXXXXX