------------------------------
------------------------------
------------------------------
------------------------------
------------------------------
SSSSS-----------S--------S-S--
------------------------------
------------------------------
SSSSS----------E-EE----EE-E-EE
---------X--X------XX---------
---------X--X------XX---------
---------X--X------XX---------
---------X--X------X----------
-----XX--X--X------X----------