------------------------------
------------------------------
------------------------------
------------------------------
------------------------------
--SS--SS-----SS-S-------------
------------------------------
------------------------------
------------------------------
------------------------------
----------E--------XXXX--XX--X
------------------------------
------------------------------
XX--XX---X-XX--X-XX----X---X--