------------------------------
------------------------------
------------------------------
------------------------------
------------------------------
-----------S---------S---S----
------------------------------
------------------------------
----------E-EE------E-EEE-EEEE
---X---X------XX-X------------
---X---X------XX-X------------
---X---X------XX-X------------
---X---X------X--X------------
---X---X------X--X------------