------------------------------
------------------------------
----------oo------------------
--------------E--E--E---------
-------------XXXXXXXXXX-------
------oo----------------------
------------------------------
------------------------------
-------XXXXXX-----------------
------------------------------
----------------------------XX
---------------------------XXX
--E---------------------------
XXXX---------------------XXXXX