------------------------------
------------------------------
------------------------------
------------------------------
------------------------------
SS--------XX-----------XXXX---
---------XXX----------XXXXX---
--------XXXX---------XXXXXX---
SS-----XXXXX--------XXXXXXX--?
-------XXXXX--------XXXXXXX---
-----XXXXXXX------XXXXXXXXX---
----XXXXXXXX-----XXXXXXXXXX---
-------XXXXX--E-----XXXXXXX---
--XXXXXXXXXXXXXXXXXXXXXXXXXXXX