------------------------------
------------------------------
------------------------------
------------------------------
------------------------------
--S---------SS---SSSSSSSSSSS--
------------------------------
------------------------------
-E-EEE-----E------------------
------XXX---------------------
------XXX---------------------
------XXX---------------------
------X-----------------------
------X--------XXXX----------X