------------------------------
------------------------------
------------------------------
------------------------------
------------------------------
------------------------------
----E--E--E----E--E----E------
-XXXXXXXXXXXXXXXXXXXXXXXXXXXXX
------------------------------
------------------------------
------------------------------
------------------------------
------------------------------
------------------------------