-----------------------------
-----------------------------
-----------------------------
-----------------------------
-----------------------------
---SSSSSS----SSSSSSSSSS------
-----------------------------
-----------------------------
-----------------------------
-----------------------------
-----------------------------
-----------------------------
--------------------------EE-
XXXXX-----XXXXX---------XXXXX