------------------------------
------------------------------
------------------------------
------------------------------
------------------------------
-------SS-------S---S-S----S--
------------------------------
------------------------------
--E--SS--------E-EEE-E-EEEE-EE
-<>---------X-----------------
-[]---------X-----------------
-[]---------X-----------------
-[]---------X-----------------
-XXXXXXX-X--X-----------------