------------------------------
------------------------------
------------------------------
------------------------------
---------------------------ooo
----S--------S-----S-S--------
------------------------------
------------------------------
------------------------------
-----E--------E-------E-----X-
----<>-------<>----<-<>-------
----[]-------[]----[-[]-------
----[]-------[]----[-[]-------
XXXXXXXXXXXXXXXXXXXXXXXXX-----