------------------------------
------------------------------
------------------------------
------------------------------
------------------------------
------------------------------
---------E--E--E----E--E----E-
-------XXXXXXXXXXXXXXXXXXXXXXX
o-----------------------------
------------------------------
------------------------------
------------------------------
---XX-------------------------
------------------------------