-------------------------
-------------------------
-------------------------
-------------------------
-------------------------
-------------------------
-------------------------
-------------------------
------oo----o-----------o
-------------------------
-------------------------
-------------------------
EE-E-----------XXX--XX---
XXXXX----X---------------