------------------------------
------------------------------
------------------------------
------------------------------
------------------------------
SSS------S---------S-------S--
------------------------------
------------------------------
SSS-----E-EE------E-EE----E-EE
------------XX-X------XX------
------------XX-X------XX------
------------XX-X------XX------
------------X--X------X-------
---XXX------X--X------X-------