------------------------------
------------------------------
------------------------------
------------------------------
------------------------------
------------------------------
------------------------------
------------------------------
-------------------o----------
------------------------------
------------------------------
------------------------------
E-E-E---E-----XXX-----XXX--XX-
XXXXXXXXXXXX------------------