------------------------------
------------------------------
------------------------------
-----------------------------X
-----------------------------X
--SS------SS-----S-SS--------X
-----------------------------X
-----------------------------X
-----------------------------X
-----------------------------X
-----------------------------X
-----------------------------X
-----------------------------X
XX--XXXXXX--XXXXX-X--XXXXXXXXX