------------------------------
------------------------------
------------------------------
------------------------------
------------------------------
-------E------oo-----E-----S--
------XXXX----------XXXX------
------------------------------
--------------------------E-EE
------------XX--XX------------
------------------------------
------------------------------
-EE---------------------------
XXXX--------------------------