------------------------------
------------------------------
------------------------------
------------------------------
------------------------------
-----SSSSS---SSSSSSSSSS-------
------------------------------
------------------------------
---SS-------------------------
------------------------------
------------------------------
------------------------------
--------------------------EE-E
XXXXXX-----XXXX---------XXXXXX