------------------------------
------------------------------
------------------------------
------------------------------
------------------------------
--------XXX-----XXXX-----SSSSS
-------XXXX-----XXXX----------
------XXXXX---XXXXXX----------
-----XXXXXX---XXXXXX----------
-----XXXXXX---XXXXXX----------
---XXXXXXXX--XXXXXXX----------
--XXXXXXXXX--XXXXXXX----------
-----XXXXXX--XXXXXXX--E-------
XXXXXXXXXXXXXXXXXXXXXXXXXXX---