------------------------------
------------------------------
------------------------------
--XX------XX------------------
--XX------XX------------------
--XX------XX--------------S-SS
--XX------XX------------------
--XX------XX------------------
--XX------XX------------------
--XX------XX------------------
--XX------XX------------------
--XX------XX------------------
--XX------XX------------------
XXXXXXXXXXXXXXXXXXXXXXXXXX-X--