------------------------------
------------------------------
------------------------------
------------------------------
-----------------------oo-----
-----------------------------o
------------------------------
------------------------------
------oo----------------------
-------------------XX---XXX---
------------------------------
------------------------------
E-E-------XX---E--------------
XXXX----------XXX-------------