------------------------------
------------------------------
------------------------------
------------------------------
------------------------------
SSS----SSSSSS--------S---S----
------------------------------
------------------------------
SSS-----------------E-EEE-EEEE
-----------------X------------
-----------------X------------
-----------------X------------
-----------------X------------
---XXXXXX-----X--X------------