------------------------------
------------------------------
------------------------------
------------------------------
----------------XX------------
------------------------------
--------------E---------------
----------XXXXXX--------------
------------------------------
--------------------------E---
---XX---XXX---------XXXXXXXXX-
------------------------------
E----E-----------------------E
XXX--XXX---------------------X