------------------------------
------------------------------
------------------------------
------------------------------
------------------------------
------------------------------
---------E--E--E--E--E----E--E
-------XXXXXXXXXXXXXXXXXXXXXXX
------------------------------
------------------------------
------------------------------
------------------------------
--XXX-------------------------
------------------------------