------------------------------
------------------------------
------------------------------
------------------------------
---------oo---------ooo-------
---------XX---------XXX-------
------------------------------
------------------------------
------------------------------
------------------------------
--XX--XX?----XX--XX?----------
------------------------------
----------------------------E-
X---X---XXXX---X---XXXX-XXXXXX