------------------------------
------------------------------
------------------------------
------------------------------
------------------------------
SSSSS---------S-------S--S----
------------------------------
------------------------------
SSSSS--------E-EE----E-EE-EEEE
-------oo--------XX-----------
-----------------XX-----------
-----------------XX-----------
-----------------X------------
-----XXXXXX------X------------