------------------------------
------------------------------
------------------------------
------------------------------
------------------------------
SSSS--------XX-----SSSSSSSSSS-
-----------XXX----------------
----------XXXX----------------
SSSS-----XXXXX----------------
---------XXXXX----------------
-------XXXXXXX----------------
------XXXXXXXX----------------
---------XXXXX--E-------------
----XXXXXXXXXXXXXXXXXXXX------