------------------------------
------------------------------
------------------------------
------------------------------
------------------------------
SSSS--SSSSSSSS------SSSSSSSSS-
------------------------------
------------------------------
SSSS--------------------------
------------------------------
------------------------------
------------------------------
------------------------------
----XXXX-------X--XXXXXX------