-------------------------
-------------------------
-------------------------
-------------------------
-------------------------
-------------S-----------
-------------------------
-----------------------oo
---------E--E-EE---------
--------<>------XX-XXX---
---E----[]------XX-XXX---
--------[]------XX-XXX---
--------[]------X--XXX---
XXXXXXXXXX------X--XX---X