-------------------------
-------------------------
-------------------------
-------------------------
-------------------------
------------XXX----------
-----------XXXX----------
----------XXXXX----------
---------XXXXXX----------
--------XXXXXXX------SS--
------EXXXXXXXX----------
------XXXXXXXXX----------
-----XXXXXXXXXX----------
X-XXXXXXXXXXXXXXXX---XXXX