-------------------------
-------------------------
-------------------------
-------------------------
----------------------oo-
-------------------------
-------------------------
-------------------------
-------------------------
-------E--<>-------------
------<>--[]-------------
------[]--[]-------------
-EE---[]--[]-------EE-EE-
XXXX-XXXXXXXXXXXXXXXXXXXX