------------------------------
------------------------------
------------------------------
------------------------------
------------------------------
--------E---------E-----------
-------XXXXX-----XXXXXXX------
------------------------------
------------------------------
------------------------------
------------------------------
------------------------------
EE-E----------------------XXXX
XXXXX---------X---------------