----------------------------
----------------------------
----------------------------
----------------------------
----------------------------
------SSSSSSSSSSSSSSSS------
----------------------------
----------------------------
----SS----------------------
----------------------------
----------------------------
----------------------------
E------------------------EE-
XXXXXXX----------------XXXXX