-------------------------
-------------------------
-------------------------
-------------------------
------------E------------
----------SSSSSSS--------
-------------------------
-------------------------
-------------------------
------Q-------------<>---
--------------------[]---
--------------------[]---
-----------------EE-[]---
XXXXXXXXXXXXXXXXXXXXXXXXX