------------------------------
------------------------------
------------------------------
------------------------------
------------------------------
--S---------S---S-S----S------
------------------------------
------------------------------
-E-EE------E-EEE-E-EEEE-EEEEE-
-----XX-X--------------------X
-----XX-X--------------------X
-----XX-X--------------------X
-----X--X--------------------X
-----X--X--------------------X