------------------------------
------------------------------
------------------------------
------------------------------
------------------------------
--SS--SSS--SS--SSSSSSS--SSS---
------------------------------
------------------------------
------------------------------
------------------------------
------------------------------
------------------------------
-----------------------------E
XX--XX---XX--XX-------XX---XXX