------------------------------
------------------------------
------------------------------
---------------------------XXX
---------------------------XXX
--SS--SSSSSSS----SS----SS--XXX
---------------------------XXX
---------------------------XXX
---------------------------XXX
---------------------------XXX
---------------------------XXX
---------------------------XXX
---------------------------XXX
XX--XX-------XXXX--XXXX--XXXXX