-------------------------
-------------------------
-------------------------
-------------------------
-------------------------
-------------------------
-------------------------
-------------------------
----------------------SSS
------SS----SS-----------
-------------------------
-------------------------
-------------------------
XXXXXXXXXXXXXXXXXXXXXXXXX