------------------------------
------------------------------
------------------------------
------------------------------
------------------------------
------------------------------
------------------------------
------------------------------
---E---E----------------------
--<>--<>----------------------
--[]--[]----------------------
--[]--[]--X-------------------
E-[]E-[]--X-------XX-X--------
XXXXXXXXXXXXXXXX--------X--X--