------------------------------
------------------------------
------------------------------
------------------------------
------------------------------
------------------------------
------------------------------
------------------------------
---------oo-----oo------------
------------------------------
------------------------------
------------------------------
EE-EE----------------XXXXX--XX
XXXXXX-------X----------------