------------------------------
------------------------------
------------------------------
--XX--XX--XX--XX--------------
--XX--XX--XX--XX--------------
--XX--XX--XX--XX---S-SSSSSSS--
--XX--XX--XX--XX--------------
--XX--XX--XX--XX--------------
--XX--XX--XX--XX--------------
--XX--XX--XX--XX--------------
--XX--XX--XX--XX--------------
--XX--XX--XX--XX--------------
--XX--XX--XX--XX--------------
XXXXXXXXXXXXXXXXXXX-X-------X-