------------------------------
------------------------------
------------------------------
------------------------------
------------------------------
SSSS-----SSSSSS---SSSSSSSSSSSS
------------------------------
------------------------------
SSSS--------------------------
------------------------------
------------------------------
------------------------------
------------------------------
----XXXXXXX-----XXXXXXXXXX----