------------------------------
------------------------------
------------------------------
------------------------------
------------------------------
SSS------S-----------SS----S--
------------------------------
------------------------------
SSS-----E-EE------E-E--EEEE-EE
------------XX-X--------------
------------XX-X--------------
------------XX-X--------------
------------X-----------------
---XXX------X-----------------