----------------------------
----------------------------
----------------------------
----------------------------
----------------------------
SSSS--SSSSSS---SSSSSSSSSSSSS
----------------------------
----------------------------
SSSS------------------------
----------------------------
----------------------------
----------------------------
----------------------------
----XXXX-----XXXXXXXXXX-----