------------------------------
------------------------------
------------------------------
------------------------------
-------------------oo---------
------------------XXXX--------
----------XXXXXX-------o------
----------------------XXX-----
------------------------------
------------------------------
---XX---XXX-----------o-----XX
---------------XXX---XXXXX----
E----E------------------------
XXX--XXX----------------------