-----------------------------
-----------------------------
-----------------------------
-----------------------------
-----------------------------
SSSS---SSSSSS---SSSSSSSSSSSS-
-----------------------------
-----------------------------
SSSS-------------------------
-----------------------------
-----------------------------
-----------------------------
-----------------------------
----XXXXX-----XXXXXXXXX------