------------------------------
------------------------------
------------------------------
------------------------------
------------------------------
------------------------------
------------------------------
------------------------------
-----------------o-----------o
------------------------------
------------------------------
------------------------------
EE-EE---XXX--XX-----XXX--XX---
XXXXXX------------------------