-------------------------
-------------------------
-------------------------
-------------------------
-------------------------
-------------------------
-------------------------
-------------------------
----------oo-------------
-X-------------E---------
-XX-----------<>---------
-XXX----------[]---------
-XXXX---------[]----E----
-XXXXXXXX----XXXXXXXXXXXX