------------------------------
------------------------------
------------------------------
------------------------------
------------------------------
---------E-------E------------
--------XXXXXX--XXXXXXX-------
------------------------------
------------------------------
------------------------------
------------------------------
------------------------------
EE-E---------------------XXXXX
XXXXXX------------------------