------------------------------
------------------------------
------------------------------
------------------------------
------------------------------
--SS--SSSSS--SS-S-------------
------------------------------
------------------------------
------------------------------
-----------------------EE-EE--
-------------------XXXXXXXXX--
------------------------------
------------------------------
XX--XX-----XX--X-XX---------X-