------------------------------
------------------------------
------------------------------
------------------------------
------------------------------
-------XXXX-----XX--SSSSSSSSSS
-------XXXX-----XX------------
-----XXXXXX---XXXX------------
-----XXXXXX---XXXX------------
-----XXXXXX---XXXX------------
----XXXXXXX--XXXXX------------
----XXXXXXX--XXXXX------------
----XXXXXXX--XXXXX------------
XXXXXXXXXXXXXXXXXXXXXXXXXXX---