------------------------------
------------------------------
------------------------------
------------------------------
------------------------------
--S--------S------------S--S--
------------------------------
------------------------------
-E-EE----EE-EEEEE-E----E-EE-EE
-----XX----------X-XX---------
-----XX----------X-XX---------
-----XX----------X-XX---------
-----X-----------X-X----------
-----X-----------X-X----------