------------------------------
------------------------------
------------------------------
------------------------------
------------------------------
--------SSSSSSSSSSSSSSSSS-----
------------------------------
------------------------------
------------------------------
------------------------------
------------------------------
------------------------------
EE-E-E----------------------EE
XXXXXXXXXX----------------XXXX