------------------------------
------------------------------
------------------------------
------------------------XX-X--
------------------------XX-X--
--SS--S--SS--SSSSS--SS--XX-X--
------------------------XX-X--
------------------------XX-X--
------------------------XX-X--
------------------------XX-X--
------------------------XX-X--
------------------------XX-X--
------------------------XX-X--
XX--XX-XX--XX-----XX--XXXXXXXX