-------------------------
-------------------------
-------------------------
-------------------------
-------------------------
-------------------------
-------------------------
-------------------------
---------------------S---
------<>-----------------
-<>---[]-----------------
-[]---[]-------<>--------
-[]-E-[]--E----[]--------
XXXXXXXXXXXXXXXXXXXXXXXXX