-------------------------
-------------------------
-------------------------
-------------------------
-------------------------
------SSS----------------
-------------------------
-------------------------
-------------------------
-------------------------
-------------------E-E---
------------------<><>---
---------E-EE-----[][]---
-XXXXXXXXXXXXXXXXXXXXXXXX