------------------------------
------------------------------
------------------------------
------------E--E--E-----------
----------XXXXXXXXXXX---------
-------------------------X----
------------------------------
------------------------------
------------------------------
------------------------------
------------------------------
------------------------------
------------------------------
XXX--XXX------------------XXX-