------------------------------
------------------------------
------------------------------
------------------------------
------------------------------
SSS------S--------S-S----S----
------------------------------
------------------------------
SSS-----E-EE----EE-E-EEEE-EEEE
------------XX----------------
------------XX----------------
------------XX----------------
------------X-----------------
---XXX------X-----------------