------------------------------
------------------------------
------------------------------
------------------------------
------------------------------
------------------------------
------------------------------
------------------------------
------------------------------
--------EE--------EE-EEEE-----
--XX--XXXX--XX--XXXXXXXXX--XX-
------------------------------
------------------------------
X---X-----X---X----------X---X