------------------------------
------------------------------
------------------------------
------------------------------
------------------------------
SS-----XXXX--SS--SSSSSSSSSSSSS
-------XXXX-------------------
-----XXXXXX-------------------
SS---XXXXXX-------------------
-----XXXXXX-------------------
----XXXXXXX-------------------
----XXXXXXX-------------------
----XXXXXXX-------------------
--XXXXXXXXXXXXXXXXXXXXXXX-----