-------------------------
-------------------------
-------------------------
-------------------------
-------------------------
-------------------------
-------------------------
-------------------------
-------------------------
-------------------------
-------------------------
-------------------------
-E-E-E-E------X----------
XXXXXXXXXXXXXXXXXXXXXXXXX