------------------------------
------------------------------
------------------------------
------------------------------
------------------------------
SSS-----------S---S-S----S----
------------------------------
------------------------------
SSS----------E-EEE-E-EEEE-EEEE
----------X-------------------
-----E----X-------------------
----------X-------------------
----------X-------------------
---XXXXX--X-------------------