------------------------------
------------------------------
------------------------------
------------------------------
------------------------------
SS--------------S------S-S----
------------------------------
------------------------------
SS-----o------EE-EEEEEE-E-EEEE
----------XX------------------
----------XX------------------
----------XX------------------
----E-----XX------------------
--XXXX----XX------------------