------------------------------
------------------------------
------------------------------
------------------------------
------------------------------
SSSS-----------S-S----S-------
------------------------------
------------------------------
SSSS---------EE-E-EEEE-EEEEEEE
---------XX-------------------
---------XX-------------------
---------XX-------------------
------E--XX-------------------
----XXXXXXX-------------------