------------------------------
------------------------------
------------------------------
------------------------------
-----------------------XX-----
--SS---SS--------------------S
------------------E--E--------
---------------XXXXXXXX-------
------------------------------
------------------------------
------------XXXX--------------
------------------------------
------------------------------
XX--XXX--X-----------------XX-