------------------------------
------------------------------
------------------------------
------------------------------
------------------------------
SS-------SSSSSSSSSSSS---SSSSSS
-----E------------------------
----<>------------------------
SS--[]------------------------
----XXX-----------------------
------------------------------
------------------------------
------------------------------
--XXXXXXXXX-----------XXXXXX--