-------------------------
-------------------------
-------------------------
-------------------------
-------------------------
-------------------------
-------------------------
-----------------------X-
---E----S--------------X-
-E<>-------E--------XX-X-
<>[]------<>--------XX-X-
[][]------[]--------XX-X-
[][]------[]-E-EE---XX-X-
XXXXXXXXXXXXXXXXXXXXXX-X-