------------------------------
------------------------------
------------------------------
------------------------------
------------------------------
------------------------------
-------------------X-XXXX-----
------------------------------
------------------------------
----------E-EE-EE-------------
--XXX--XXXXXXXXXXXXXXX--------
------------------------------
----------------------------E-
X----X---------------------XXX