------------------------------
------------------------------
------------------------------
------------------------------
------------------------------
--------XXXXX--SSSSSSSS---SSSS
--------XXXXX-----------------
------XXXXXXX-----------------
------XXXXXXX-----------------
------XXXXXXX-----------------
-----XXXXXXXX-----------------
-----XXXXXXXX-----------------
--E--XXXXXXXX-----------------
XXXXXXXXXXXXXXXXX-------XXXXXX