------------------------------
------------------------------
------------------------------
------------------------------
-----------------------------X
------------------------------
---------------------------E--
------------------------XXXXX-
------------------------------
--------EE-EE-EE--------------
--XX--XXXXXXXXXXXXXX--XXX-----
------------------------------
------------------------------
X---X---------------X---------