------------------------------
------------------------------
------------------------------
-----------------------X-XX--X
-----------------------X-XX--X
--SS--SSSSS----SS--SS--X-XX--X
-----------------------X-XX--X
-----------------------X-XX--X
-----------------------X-XX--X
-----------------------X-XX--X
-----------------------X-XX--X
-----------------------X-XX--X
-----------------------X-XX--X
XX--XX-----XXXX--XX--XXXXXXXXX