------------------------------
------------------------------
------------------------------
------------------------------
------------------------------
SS-------SSSSSSSSSSSS---SSSSSS
------------------------------
------------------------------
SS----------------------------
------S-----------------------
------------------------------
------------------------------
------------------------------
--XXXXXXXXX-----------XXXXXX--