------------------------------
------------------------------
------------------------------
------------------------------
--------------------XX--------
------------------------------
------------------E-----------
---------------XXXXX----------
------------------------------
---------EE-E-----------------
---X---XXXXXXXXX--------XXXXX-
------------------------------
E---E------------------------E
XXX-XXX----------------------X