------------------------------
------------------------------
------------------------------
------------------------------
------------------------------
--S----------SSSS------S-S----
------------------------------
------------------------------
-E-EEE-----------EEEEEE-E-EEEE
------XX----------------------
------XX----------------------
------XX----------------------
------X-----------------------
------X---XXXXX---------------