------------------------------
------------------------------
------------------------------
------------------------------
------------------------------
------------------------------
---------------------------XXX
------------------------------
------------------------------
--------EE--------EE-E-EE-----
--XX--XXXX--XX--XXXXXXXXXXXX--
------------------------------
------------------------------
X---X-----X---X---------------