------------------------------
------------------------------
------------------------------
----------------E-------------
--------------XXXXX-----------
------------------------------
------------E-----------------
--------XXXXXX----------------
------------------------------
------------------------------
--XX--XXX------------XXXXXXXXX
------------------------------
------------------------------
X---X-------------------------