------------------------------
------------------------------
------------------------------
------------------------------
------------------------------
------------------------------
---------------E--------------
--------------<>--------------
--------------[]------o-------
S--Q----------[]--------------
------------E-[]--------------
-----------<>-[]--------------
---E-------[]-[]--EE-----XXX--
XXXXXXXXXXXXXXXXXXXXX---------