-------------------------
-------------------------
-------------------------
-------------------------
-------------------------
---------?SSS------------
-----------------------E-
----------------------<>-
-------E-------E------[]-
------<>---E--<>------[]-
------[]--<>--[]----E-[]-
------[]--[]--[]---<>-[]-
------[]--[]--[]---[]-[]-
XXXXXXXXXXXXXXXXXXXXXXXXX