-------------------------
-------------------------
-------------------------
-------------------------
-----------E-------------
----SSSSSSSSSSSS---------
-------------------------
-------------------------
-S-----------------------
---------------------<>--
---------------------[]--
---------------------[]--
----------------EE-E-[]--
XXXXXXXXXXXXXXXXXXXXXXXXX