------------------------------
------------------------------
------------------------------
----------X----------XX-------
----------X----------XX-------
--SS--SS--X--SS--SS--XX--S-SS-
----------X----------XX-------
----------X----------XX-------
----------X----------XX-------
----------X----------XX-------
----------X----------XX-------
----------X----------XX-------
----------X----------XX-------
XX--XX--XXXXX--XX--XXXXXX-X--X