------------------------------
------------------------------
------------------------------
------------------------------
------------------------------
SSSSS-----------S---S-S----S--
------------------------------
------------------------------
SSSSS----------E-EEE-E-EEEE-EE
------------X-----------------
------------X-----------------
------------X-----------------
-------EE---X-----------------
-----XXXXX--X-----------------