------------------------------
------------------------------
------------------------------
--XX---XX-----------XX-X---XX-
--XX---XX-----------XX-X---XX-
--XX---XX--SSSSSSS--XX-X---XX-
--XX---XX-----------XX-X---XX-
--XX---XX-----------XX-X---XX-
--XX---XX-----------XX-X---XX-
--XX---XX-----------XX-X---XX-
--XX---XX-----------XX-X---XX-
--XX---XX-----------XX-X---XX-
--XX---XX-----------XX-X---XX-
XXXXXXXXXXX-------XXXXXXXXXXXX