-------------------------
-------------------------
-------------------------
-------------------------
-------------------------
-----------------?-------
-------------------------
-------------------------
-------------------------
-----------------Q-------
-------------------------
-------------------------
---E-E-E-----------------
XXXXXXXXXXXXXXXXXXXXXXXXX