------------------------------
------------------------------
------------------------------
---------------------------E--
-------------------------XXXXX
--SS--SSSSSS------------------
-----------------------E------
--------------------XXXXX-----
------------------------------
------------------------------
------------------XXX---------
------------------------------
------------------------------
XX--XX------X-X-X-------------