------------------------------
------------------------------
------------------------------
------------------------------
------------------------------
--S-----SSSSSS----------------
------------------------------
------------------------------
-E-EEE--------EEEEEEEEEEEEEEEE
------XX----------------------
------XX----------------------
------XXX---------------------
------XXX---------------------
------XXXXXX------------------