------------------------------
------------------------------
------------------------------
------------------------------
------------------------------
SSSSS--------SSSS------S-S----
------------------------------
------------------------------
SSSSS------------EEEEEE-E-EEEE
------------------------------
------------------------------
------------------------------
------------------------------
-----XXXX-XXXXX---------------