------------------------------
------------------------------
------------------------------
------------------------------
------------------------------
--SS--SS--SS--SSSSS-----------
------------------------------
------------------------------
------------------------------
-------------------------EE-EE
---------------------X-XXXXXXX
------------------------------
------------------------------
XX--XX--XX--XX-----X----------