------------------------------
------------------------------
------------------------------
------------------------------
----------------------XX------
------------------------------
--------------------E---------
-----------------XXXXX--------
------------------------------
----------EE-EE---------------
---XX---XXXXXXXXXX------------
------------------------------
E----E---------------------E-E
XXX--XXX------------------XXXX