------------------------------
------------------------------
------------------------------
------------------------------
------------------------------
--S--------S-----S------S-----
------------------------------
------------------------------
-E-EEE----E-EEEEE-EEEEEE-EEEEE
------XX----------------------
------XX----------------------
------XX----------------------
------X-----------------------
------X-----------------------