------------------------------
------------------------------
------------------------------
------------------------------
--------------XX--------------
------------------------------
------------E-----------------
--------XXXXXX----------------
------------------------------
--------------------E-E-EE----
--XX--XXX---------XXXXXXXX--XX
------------------------------
------------------------------
X---X---------------------X---