------------------------------
------------------------------
------------------------------
------------------------------
------------------------------
-----------SSS----------------
----------------------E-------
---------------------<>-------
---E-----------------[]-----oo
--<>------XXXXX------XX-------
--[]------X-------------------
--[]------X-------------B-----
--[]------X-------------b-----
XXXXXXXXXXXXX----X--XXXXXXX---