-------------------------
-------------------------
-------------------------
-----XX------------------
-----XX------------------
-----XX------------------
-----XX------------------
-----XX------------------
-----XX------------?-----
-----XX------------------
-----XX------------------
-----XX------------------
-----XX------E-----------
XXXXXXXXXXXXXXXXXXXXXXXXX