------------------------------
------------------------------
------------------------------
------------------------------
------------------------------
SSSSS---SSSS------------------
------------------------------
------------------------------
SSSSS-------EEEEEEEEEEEEEEEEEE
------------------------------
------------------------------
------------------------------
------------------------------
-----XXXXX--------------------