------------------------------
------------------------------
------------------------------
------------------------------
------------------------------
SSS-----SSSSSSS---SSSS----S---
------------------------------
------------------------------
SSS---SS--------------EEEE-EEE
------------------------------
------------------------------
------------------------------
------------------------------
---XXXXXX-------XXXX----------