------------------------------
------------------------------
------------------------------
------------------------------
------------------------------
SSSS--------S-----S------S----
------------------------------
------------------------------
SSSS------EE-EEEEE-EEEEEE-EEEE
------------------------------
------------------------------
------------------------------
------------------------------
----XX------------------------