------------------------------
------------------------------
------------------------------
------------------------------
------------------------------
SS-------SSSSSSSSSSSSSSSSS----
------------------------------
------------------------------
SS----------------------------
------------------------------
------------------------------
------------------------------
----EEE-----------------------
--XXXXXXXXX----------------XXX