------------------------------
------------------------------
------------------------------
------------------------------
--------------------XX--------
------------------------------
---------------E--E-----------
----------XXXXXXXXXX----------
------------------------------
--------------------------E-E-
---XX---XXX-------------XXXXXX
------------------------------
E----E------------------------
XXX--XXX----------------------