------------------------------
------------------------------
------------------------------
------------------------------
------------------------------
------------------------------
------------------------------
------------------------------
------------------------------
----------EEEE-EE---------EE-E
--XX--XXXXXXXXXXXX--XX--XXXXXX
------------------------------
------------------------------
X---X-------------X---X-------