------------------------------
------------------------------
------------------------------
------------------------------
--------------------------XX--
--SS--SSSSSSSS----------------
------------------------E-----
---------------------XXXXX----
------------------------------
------------------------------
----------------XXXXXX--------
------------------------------
------------------------------
XX--XX--------XX--------------