------------------------------
------------------------------
------------------------------
------------------------------
------------------------------
--S---------------------------
------------------------------
------------------------------
-E-EEE-----EEEEEEEEEEEEEEEEEEE
------XXX---------------------
------XXX---------------------
------XXX---------------------
------X-----------------------
------X-----------------------