------------------------------
------------------------------
------------------------------
------------------------------
------------------------------
SSS------SSSSSSSSS---SSSS----S
------------------------------
------------------------------
SSS----------------------EEEE-
------------------------------
------------------------------
------------------------------
------------------------------
---XXXXXXXX--------XXXX-------